"","country_territory","region","c_t","edition","status","pr_rating","cl_rating","a","b","c","add_q","add_a","pr","d","e","f","g","cl","total"
"1","Abkhazia","Eurasia","t",2022,"PF",5,5,5,8,4,0,"N/A",17,8,6,4,5,23,40
"2","Afghanistan","Asia","c",2022,"NF",7,6,0,0,1,0,"N/A",1,4,3,0,2,9,10
"3","Albania","Europe","c",2022,"PF",3,3,9,12,7,0,"N/A",28,13,8,9,9,39,67
"4","Algeria","Africa","c",2022,"NF",6,5,3,4,3,0,"N/A",10,6,3,6,7,22,32
"5","Andorra","Europe","c",2022,"F",1,1,12,15,11,0,"N/A",38,14,11,15,15,55,93
"6","Angola","Africa","c",2022,"NF",6,5,3,5,2,0,"N/A",10,7,5,5,3,20,30
"7","Antigua and Barbuda","Americas","c",2022,"F",2,2,12,13,8,0,"N/A",33,15,10,14,13,52,85
"8","Argentina","Americas","c",2022,"F",2,2,11,16,8,0,"N/A",35,15,11,10,13,49,84
"9","Armenia","Eurasia","c",2022,"PF",4,4,7,10,6,0,"N/A",23,9,8,6,9,32,55
"10","Australia","Asia","c",2022,"F",1,1,12,15,12,0,"N/A",39,15,12,15,14,56,95
"11","Austria","Europe","c",2022,"F",1,1,12,15,10,0,"N/A",37,14,12,15,15,56,93
"12","Azerbaijan","Eurasia","c",2022,"NF",7,7,0,2,0,0,"N/A",2,2,1,0,4,7,9
"13","Bahamas","Americas","c",2022,"F",1,1,12,16,10,0,"N/A",38,15,12,13,13,53,91
"14","Bahrain","Middle East","c",2022,"NF",7,6,2,0,2,2,"N/A",2,2,1,1,6,10,12
"15","Bangladesh","Asia","c",2022,"PF",5,5,4,7,4,0,"N/A",15,6,5,4,9,24,39
"16","Barbados","Americas","c",2022,"F",1,1,12,16,10,0,"N/A",38,16,12,14,15,57,95
"17","Belarus","Eurasia","c",2022,"NF",7,7,0,1,1,0,"N/A",2,1,0,0,5,6,8
"18","Belgium","Europe","c",2022,"F",1,1,12,16,11,0,"N/A",39,15,12,15,15,57,96
"19","Belize","Americas","c",2022,"F",2,1,12,14,8,0,"N/A",34,16,11,13,13,53,87
"20","Benin","Africa","c",2022,"PF",5,3,3,9,5,0,"N/A",17,14,8,10,10,42,59
"21","Bhutan","Asia","c",2022,"PF",3,4,10,12,8,1,"N/A",29,9,5,9,9,32,61
"22","Bolivia","Americas","c",2022,"PF",3,3,10,10,7,0,"N/A",27,14,9,6,10,39,66
"23","Bosnia and Herzegovina","Europe","c",2022,"PF",4,4,6,9,4,0,"N/A",19,10,7,7,10,34,53
"24","Botswana","Africa","c",2022,"F",3,2,10,10,8,0,"N/A",28,12,10,11,11,44,72
"25","Brazil","Americas","c",2022,"F",2,3,10,14,7,0,"N/A",31,13,9,8,12,42,73
"26","Brunei","Asia","c",2022,"NF",6,5,0,3,4,0,"N/A",7,6,3,5,7,21,28
"27","Bulgaria","Europe","c",2022,"F",2,2,11,14,8,0,"N/A",33,13,11,10,12,46,79
"28","Burkina Faso","Africa","c",2022,"PF",4,4,7,10,6,0,"N/A",23,11,7,5,7,30,53
"29","Burundi","Africa","c",2022,"NF",7,6,1,3,0,0,"N/A",4,4,1,1,4,10,14
"30","Cabo Verde","Africa","c",2022,"F",1,1,12,16,10,0,"N/A",38,16,11,14,13,54,92
"31","Cambodia","Asia","c",2022,"NF",7,5,1,2,2,0,"N/A",5,7,3,3,6,19,24
"32","Cameroon","Africa","c",2022,"NF",6,6,1,3,2,0,"N/A",6,4,2,0,3,9,15
"33","Canada","Americas","c",2022,"F",1,1,12,16,12,0,"N/A",40,15,12,15,16,58,98
"34","Central African Republic","Africa","c",2022,"NF",7,7,2,2,0,1,"N/A",3,3,1,0,0,4,7
"35","Chad","Africa","c",2022,"NF",7,6,0,1,0,0,"N/A",1,6,4,1,3,14,15
"36","Chile","Americas","c",2022,"F",1,1,12,15,11,0,"N/A",38,16,12,13,15,56,94
"37","China","Asia","c",2022,"NF",7,6,0,0,1,3,"N/A",-2,1,2,2,6,11,9
"38","Colombia","Americas","c",2022,"PF",3,3,10,11,8,0,"N/A",29,12,5,9,9,35,64
"39","Comoros","Africa","c",2022,"PF",5,4,5,7,4,0,"N/A",16,8,6,6,6,26,42
"40","Congo (Brazzaville)","Africa","c",2022,"NF",7,6,0,2,0,0,"N/A",2,6,2,1,6,15,17
"41","Congo (Kinshasa)","Africa","c",2022,"NF",7,6,1,2,1,0,"N/A",4,7,3,1,4,15,19
"42","Costa Rica","Americas","c",2022,"F",1,1,12,15,11,0,"N/A",38,16,11,13,13,53,91
"43","Cote d'Ivoire","Africa","c",2022,"PF",4,4,6,9,4,0,"N/A",19,10,7,6,7,30,49
"44","Crimea","Eurasia","t",2022,"NF",7,6,0,0,0,2,"N/A",-2,2,1,0,6,9,7
"45","Croatia","Europe","c",2022,"F",1,2,12,14,10,0,"N/A",36,13,12,11,13,49,85
"46","Cuba","Americas","c",2022,"NF",7,6,0,0,1,0,"N/A",1,4,0,1,6,11,12
"47","Cyprus","Europe","c",2022,"F",1,1,12,15,11,0,"N/A",38,15,11,15,14,55,93
"48","Czech Republic","Europe","c",2022,"F",1,1,12,15,9,0,"N/A",36,14,12,14,15,55,91
"49","Denmark","Europe","c",2022,"F",1,1,12,16,12,0,"N/A",40,16,12,14,15,57,97
"50","Djibouti","Africa","c",2022,"NF",7,5,2,3,0,0,"N/A",5,6,3,4,6,19,24
"51","Dominica","Americas","c",2022,"F",1,1,11,16,10,0,"N/A",37,15,11,15,15,56,93
"52","Dominican Republic","Americas","c",2022,"PF",3,3,9,11,7,0,"N/A",27,14,10,8,9,41,68
"53","Eastern Donbas","Eurasia","t",2022,"NF",7,7,0,0,0,1,"N/A",-1,2,0,0,3,5,4
"54","Ecuador","Americas","c",2022,"F",2,3,11,13,7,0,"N/A",31,13,9,8,10,40,71
"55","Egypt","Africa","c",2022,"NF",6,6,2,2,2,0,"N/A",6,3,1,2,6,12,18
"56","El Salvador","Americas","c",2022,"PF",3,4,10,12,4,0,"N/A",26,11,8,6,8,33,59
"57","Equatorial Guinea","Africa","c",2022,"NF",7,7,0,0,0,0,"N/A",0,2,0,0,3,5,5
"58","Eritrea","Africa","c",2022,"NF",7,7,0,0,1,0,"N/A",1,1,0,0,1,2,3
"59","Estonia","Europe","c",2022,"F",1,1,12,15,11,0,"N/A",38,16,12,14,14,56,94
"60","Eswatini","Africa","c",2022,"NF",7,6,0,1,0,0,"N/A",1,5,2,4,5,16,17
"61","Ethiopia","Africa","c",2022,"NF",5,6,4,4,4,0,"N/A",12,4,3,1,3,11,23
"62","Fiji","Asia","c",2022,"PF",4,3,7,9,7,0,"N/A",23,11,7,7,10,35,58
"63","Finland","Europe","c",2022,"F",1,1,12,16,12,0,"N/A",40,16,12,16,16,60,100
"64","France","Europe","c",2022,"F",1,2,12,15,11,0,"N/A",38,14,10,13,14,51,89
"65","Gabon","Africa","c",2022,"NF",7,5,0,2,1,0,"N/A",3,7,3,3,5,18,21
"66","Gaza Strip","Middle East","t",2022,"NF",7,6,0,2,1,0,"N/A",3,4,2,0,2,8,11
"67","Georgia","Eurasia","c",2022,"PF",4,3,7,8,7,0,"N/A",22,9,7,8,12,36,58
"68","Germany","Europe","c",2022,"F",1,1,12,15,12,0,"N/A",39,14,12,14,15,55,94
"69","Ghana","Africa","c",2022,"F",2,2,12,13,10,0,"N/A",35,14,10,10,11,45,80
"70","Greece","Europe","c",2022,"F",1,2,12,15,10,0,"N/A",37,14,11,11,14,50,87
"71","Grenada","Americas","c",2022,"F",1,2,11,16,10,0,"N/A",37,15,11,13,13,52,89
"72","Guatemala","Americas","c",2022,"PF",4,4,7,10,4,0,"N/A",21,11,6,5,8,30,51
"73","Guinea","Africa","c",2022,"NF",6,5,1,7,2,0,"N/A",10,10,4,4,6,24,34
"74","Guinea-Bissau","Africa","c",2022,"PF",5,4,7,8,2,0,"N/A",17,10,6,5,5,26,43
"75","Guyana","Americas","c",2022,"F",2,3,9,13,8,0,"N/A",30,15,11,8,9,43,73
"76","Haiti","Americas","c",2022,"NF",6,5,3,5,3,0,"N/A",11,9,4,4,5,22,33
"77","Honduras","Americas","c",2022,"PF",4,4,8,9,4,0,"N/A",21,9,5,4,8,26,47
"78","Hong Kong","Asia","t",2022,"PF",6,4,0,5,5,0,"N/A",10,8,3,9,13,33,43
"79","Hungary","Europe","c",2022,"PF",3,3,9,11,6,0,"N/A",26,10,10,10,13,43,69
"80","Iceland","Europe","c",2022,"F",1,1,12,15,10,0,"N/A",37,15,12,15,15,57,94
"81","India","Asia","c",2022,"PF",2,4,12,12,9,0,"N/A",33,9,7,8,9,33,66
"82","Indian Kashmir","Asia","t",2022,"NF",6,5,2,3,2,0,"N/A",7,6,3,4,7,20,27
"83","Indonesia","Asia","c",2022,"PF",2,4,11,13,6,0,"N/A",30,9,6,5,9,29,59
"84","Iran","Middle East","c",2022,"NF",7,6,2,2,0,0,"N/A",4,2,1,3,4,10,14
"85","Iraq","Middle East","c",2022,"NF",5,6,8,7,2,1,"N/A",16,4,4,1,4,13,29
"86","Ireland","Europe","c",2022,"F",1,1,12,16,11,0,"N/A",39,16,12,14,16,58,97
"87","Israel","Middle East","c",2022,"F",2,3,12,13,9,0,"N/A",34,12,8,11,11,42,76
"88","Italy","Europe","c",2022,"F",1,1,12,14,10,0,"N/A",36,15,12,13,14,54,90
"89","Jamaica","Americas","c",2022,"F",2,2,12,13,9,0,"N/A",34,15,11,9,11,46,80
"90","Japan","Asia","c",2022,"F",1,1,12,16,12,0,"N/A",40,15,12,15,14,56,96
"91","Jordan","Middle East","c",2022,"NF",6,5,2,6,3,0,"N/A",11,7,1,7,7,22,33
"92","Kazakhstan","Eurasia","c",2022,"NF",7,5,1,3,1,0,"N/A",5,4,2,4,8,18,23
"93","Kenya","Africa","c",2022,"PF",4,4,6,8,5,0,"N/A",19,10,7,5,7,29,48
"94","Kiribati","Asia","c",2022,"F",1,1,12,15,10,0,"N/A",37,16,12,15,13,56,93
"95","Kosovo","Europe","c",2022,"PF",3,4,9,11,5,0,"N/A",25,9,8,6,8,31,56
"96","Kuwait","Middle East","c",2022,"PF",5,5,3,7,4,0,"N/A",14,6,4,7,6,23,37
"97","Kyrgyzstan","Eurasia","c",2022,"NF",7,5,2,3,0,1,"N/A",4,10,4,2,7,23,27
"98","Laos","Asia","c",2022,"NF",7,6,0,0,2,0,"N/A",2,3,0,2,6,11,13
"99","Latvia","Europe","c",2022,"F",1,2,12,15,10,0,"N/A",37,14,12,11,14,51,88
"100","Lebanon","Middle East","c",2022,"PF",5,4,5,7,1,0,"N/A",13,10,8,5,6,29,42
"101","Lesotho","Africa","c",2022,"PF",3,3,10,11,6,0,"N/A",27,12,7,8,9,36,63
"102","Liberia","Africa","c",2022,"PF",3,4,8,12,7,0,"N/A",27,11,7,6,9,33,60
"103","Libya","Africa","c",2022,"NF",7,6,0,1,0,0,"N/A",1,4,2,0,2,8,9
"104","Liechtenstein","Europe","c",2022,"F",2,1,10,13,10,0,"N/A",33,16,12,14,15,57,90
"105","Lithuania","Europe","c",2022,"F",1,2,12,16,10,0,"N/A",38,15,11,11,14,51,89
"106","Luxembourg","Europe","c",2022,"F",1,1,12,16,10,0,"N/A",38,16,12,15,16,59,97
"107","Madagascar","Africa","c",2022,"PF",3,4,9,11,7,0,"N/A",27,11,8,7,8,34,61
"108","Malawi","Africa","c",2022,"PF",3,3,9,12,8,0,"N/A",29,13,8,9,7,37,66
"109","Malaysia","Asia","c",2022,"PF",4,4,6,9,5,0,"N/A",20,8,6,7,9,30,50
"110","Maldives","Asia","c",2022,"PF",4,5,7,8,4,0,"N/A",19,3,5,6,7,21,40
"111","Mali","Africa","c",2022,"NF",6,5,1,5,2,0,"N/A",8,10,6,4,4,24,32
"112","Malta","Europe","c",2022,"F",2,1,12,14,9,0,"N/A",35,14,12,14,14,54,89
"113","Marshall Islands","Asia","c",2022,"F",1,1,12,16,10,0,"N/A",38,16,11,15,13,55,93
"114","Mauritania","Africa","c",2022,"PF",5,5,6,4,4,0,"N/A",14,9,4,4,4,21,35
"115","Mauritius","Africa","c",2022,"F",1,2,11,15,10,0,"N/A",36,14,11,13,12,50,86
"116","Mexico","Americas","c",2022,"PF",3,4,9,13,5,0,"N/A",27,12,7,5,9,33,60
"117","Micronesia","Asia","c",2022,"F",1,1,12,15,10,0,"N/A",37,16,11,15,13,55,92
"118","Moldova","Eurasia","c",2022,"PF",3,3,10,12,5,0,"N/A",27,12,8,6,9,35,62
"119","Monaco","Europe","c",2022,"F",3,1,8,10,9,0,"N/A",27,16,12,14,15,57,84
"120","Mongolia","Asia","c",2022,"F",1,2,11,16,9,0,"N/A",36,14,11,11,12,48,84
"121","Montenegro","Europe","c",2022,"PF",3,3,9,11,6,0,"N/A",26,12,9,9,11,41,67
"122","Morocco","Africa","c",2022,"PF",5,5,5,5,3,0,"N/A",13,7,5,5,7,24,37
"123","Mozambique","Africa","c",2022,"PF",5,4,3,7,4,0,"N/A",14,9,6,6,8,29,43
"124","Myanmar","Asia","c",2022,"NF",7,6,0,3,1,4,"N/A",0,3,2,0,4,9,9
"125","Nagorno-Karabakh","Eurasia","t",2022,"PF",5,5,7,7,3,1,"N/A",16,7,6,3,4,20,36
"126","Namibia","Africa","c",2022,"F",2,2,11,12,8,0,"N/A",31,14,11,11,10,46,77
"127","Nauru","Asia","c",2022,"F",2,3,12,14,8,0,"N/A",34,13,9,9,12,43,77
"128","Nepal","Asia","c",2022,"PF",3,4,10,10,5,0,"N/A",25,10,7,7,8,32,57
"129","Netherlands","Europe","c",2022,"F",1,1,12,16,11,0,"N/A",39,16,12,15,15,58,97
"130","New Zealand","Asia","c",2022,"F",1,1,12,16,12,0,"N/A",40,16,12,15,16,59,99
"131","Nicaragua","Americas","c",2022,"NF",7,5,0,3,2,0,"N/A",5,5,2,3,8,18,23
"132","Niger","Africa","c",2022,"PF",4,4,8,9,6,0,"N/A",23,10,6,6,6,28,51
"133","Nigeria","Africa","c",2022,"PF",4,5,6,9,5,0,"N/A",20,9,6,4,4,23,43
"134","North Korea","Asia","c",2022,"NF",7,7,0,0,0,0,"N/A",0,0,0,0,3,3,3
"135","North Macedonia","Europe","c",2022,"PF",3,3,9,12,7,0,"N/A",28,12,8,9,10,39,67
"136","Northern Cyprus","Europe","t",2022,"F",3,2,9,12,6,0,"N/A",27,15,11,13,11,50,77
"137","Norway","Europe","c",2022,"F",1,1,12,16,12,0,"N/A",40,16,12,16,16,60,100
"138","Oman","Middle East","c",2022,"NF",6,5,2,2,2,0,"N/A",6,5,4,4,5,18,24
"139","Pakistan","Asia","c",2022,"PF",5,5,5,6,4,0,"N/A",15,6,6,4,6,22,37
"140","Pakistani Kashmir","Asia","t",2022,"NF",6,5,4,4,3,2,"N/A",9,6,4,4,6,20,29
"141","Palau","Asia","c",2022,"F",1,1,12,15,10,0,"N/A",37,16,11,15,13,55,92
"142","Panama","Americas","c",2022,"F",2,2,12,15,8,0,"N/A",35,15,11,10,12,48,83
"143","Papua New Guinea","Asia","c",2022,"PF",4,3,7,13,3,0,"N/A",23,14,10,7,8,39,62
"144","Paraguay","Americas","c",2022,"PF",3,3,10,12,6,0,"N/A",28,12,8,7,10,37,65
"145","Peru","Americas","c",2022,"F",2,3,10,13,7,0,"N/A",30,15,8,8,11,42,72
"146","Philippines","Asia","c",2022,"PF",3,4,9,10,6,0,"N/A",25,11,6,3,10,30,55
"147","Poland","Europe","c",2022,"F",2,2,10,16,8,0,"N/A",34,13,10,10,14,47,81
"148","Portugal","Europe","c",2022,"F",1,1,12,16,11,0,"N/A",39,16,11,14,15,56,95
"149","Qatar","Middle East","c",2022,"NF",6,5,2,2,3,0,"N/A",7,7,2,5,4,18,25
"150","Romania","Europe","c",2022,"F",2,2,12,14,9,0,"N/A",35,13,11,12,12,48,83
"151","Russia","Eurasia","c",2022,"NF",7,6,0,3,2,0,"N/A",5,3,2,2,7,14,19
"152","Rwanda","Africa","c",2022,"NF",6,6,2,2,4,0,"N/A",8,3,2,2,7,14,22
"153","Samoa","Asia","c",2022,"F",2,2,9,14,9,0,"N/A",32,14,11,14,12,51,83
"154","San Marino","Europe","c",2022,"F",1,1,12,15,11,0,"N/A",38,15,12,13,15,55,93
"155","Sao Tome and Principe","Africa","c",2022,"F",2,2,11,15,9,0,"N/A",35,15,11,12,11,49,84
"156","Saudi Arabia","Middle East","c",2022,"NF",7,7,0,0,1,0,"N/A",1,2,0,2,2,6,7
"157","Senegal","Africa","c",2022,"PF",3,3,9,12,8,0,"N/A",29,13,7,8,11,39,68
"158","Serbia","Europe","c",2022,"PF",4,3,7,9,5,0,"N/A",21,12,8,9,12,41,62
"159","Seychelles","Africa","c",2022,"F",2,2,12,13,9,0,"N/A",34,14,9,11,11,45,79
"160","Sierra Leone","Africa","c",2022,"PF",3,3,10,11,7,0,"N/A",28,12,6,9,10,37,65
"161","Singapore","Asia","c",2022,"PF",4,4,4,8,7,0,"N/A",19,7,3,7,11,28,47
"162","Slovakia","Europe","c",2022,"F",1,1,12,15,10,0,"N/A",37,15,12,12,14,53,90
"163","Slovenia","Europe","c",2022,"F",1,2,12,16,10,0,"N/A",38,14,10,14,14,52,90
"164","Solomon Islands","Asia","c",2022,"F",2,2,9,14,7,0,"N/A",30,16,10,11,12,49,79
"165","Somalia","Africa","c",2022,"NF",7,7,0,1,0,0,"N/A",1,3,3,0,0,6,7
"166","Somaliland","Africa","t",2022,"PF",4,4,7,10,5,0,"N/A",22,8,6,7,6,27,49
"167","South Africa","Africa","c",2022,"F",2,2,12,13,8,0,"N/A",33,15,12,9,10,46,79
"168","South Korea","Asia","c",2022,"F",2,2,11,13,9,0,"N/A",33,14,11,12,13,50,83
"169","South Ossetia","Eurasia","t",2022,"NF",7,6,2,2,0,2,"N/A",2,3,2,1,3,9,11
"170","South Sudan","Africa","c",2022,"NF",7,7,0,1,0,4,"N/A",-3,2,2,0,0,4,1
"171","Spain","Europe","c",2022,"F",1,1,12,16,9,0,"N/A",37,14,11,13,15,53,90
"172","Sri Lanka","Asia","c",2022,"PF",4,4,9,10,5,1,"N/A",23,8,9,7,8,32,55
"173","St. Kitts and Nevis","Americas","c",2022,"F",2,1,10,15,10,0,"N/A",35,16,12,13,13,54,89
"174","St. Lucia","Americas","c",2022,"F",1,1,11,16,11,0,"N/A",38,15,12,13,14,54,92
"175","St. Vincent and the Grenadines","Americas","c",2022,"F",1,1,11,15,10,0,"N/A",36,15,12,14,14,55,91
"176","Sudan","Africa","c",2022,"NF",7,6,0,2,0,2,"N/A",0,5,2,0,3,10,10
"177","Suriname","Americas","c",2022,"F",2,2,11,14,9,0,"N/A",34,15,11,9,10,45,79
"178","Sweden","Europe","c",2022,"F",1,1,12,16,12,0,"N/A",40,16,12,16,16,60,100
"179","Switzerland","Europe","c",2022,"F",1,1,12,15,12,0,"N/A",39,15,12,15,15,57,96
"180","Syria","Middle East","c",2022,"NF",7,7,0,0,0,3,"N/A",-3,3,0,0,1,4,1
"181","Taiwan","Asia","c",2022,"F",1,1,12,15,11,0,"N/A",38,16,11,15,14,56,94
"182","Tajikistan","Eurasia","c",2022,"NF",7,6,0,0,0,0,"N/A",0,1,2,1,4,8,8
"183","Tanzania","Africa","c",2022,"PF",5,5,3,5,4,0,"N/A",12,7,4,4,7,22,34
"184","Thailand","Asia","c",2022,"NF",7,5,1,2,2,0,"N/A",5,6,3,5,10,24,29
"185","The Gambia","Africa","c",2022,"PF",4,4,8,9,4,0,"N/A",21,8,6,6,6,26,47
"186","Tibet","Asia","t",2022,"NF",7,7,0,0,1,3,"N/A",-2,0,0,0,3,3,1
"187","Timor-Leste","Asia","c",2022,"F",2,3,11,14,8,0,"N/A",33,14,8,8,9,39,72
"188","Togo","Africa","c",2022,"PF",5,4,4,6,5,0,"N/A",15,9,5,6,7,27,42
"189","Tonga","Asia","c",2022,"F",2,2,9,14,7,0,"N/A",30,14,10,12,13,49,79
"190","Transnistria","Eurasia","t",2022,"NF",6,6,1,4,1,0,"N/A",6,4,1,2,5,12,18
"191","Trinidad and Tobago","Americas","c",2022,"F",2,2,11,13,9,0,"N/A",33,16,11,9,13,49,82
"192","Tunisia","Africa","c",2022,"PF",3,3,9,13,4,0,"N/A",26,12,7,9,10,38,64
"193","Turkey","Europe","c",2022,"NF",5,6,5,8,3,0,"N/A",16,5,3,3,5,16,32
"194","Turkmenistan","Eurasia","c",2022,"NF",7,7,0,0,0,0,"N/A",0,0,0,0,2,2,2
"195","Tuvalu","Asia","c",2022,"F",1,1,12,15,10,0,"N/A",37,16,12,15,13,56,93
"196","Uganda","Africa","c",2022,"NF",6,5,3,5,3,0,"N/A",11,8,4,4,7,23,34
"197","Ukraine","Eurasia","c",2022,"PF",3,3,9,12,5,0,"N/A",26,11,8,6,10,35,61
"198","United Arab Emirates","Middle East","c",2022,"NF",7,6,1,2,2,0,"N/A",5,3,2,3,4,12,17
"199","United Kingdom","Europe","c",2022,"F",1,1,12,16,11,0,"N/A",39,14,12,13,15,54,93
"200","United States","Americas","c",2022,"F",2,2,10,13,9,0,"N/A",32,14,11,11,15,51,83
"201","Uruguay","Americas","c",2022,"F",1,1,12,16,12,0,"N/A",40,16,12,14,15,57,97
"202","Uzbekistan","Eurasia","c",2022,"NF",7,6,1,0,1,0,"N/A",2,3,1,1,4,9,11
"203","Vanuatu","Asia","c",2022,"F",2,2,10,15,8,0,"N/A",33,14,11,13,11,49,82
"204","Venezuela","Americas","c",2022,"NF",7,6,0,1,0,0,"N/A",1,6,2,1,4,13,14
"205","Vietnam","Asia","c",2022,"NF",7,6,0,1,2,0,"N/A",3,3,1,4,8,16,19
"206","West Bank","Middle East","t",2022,"NF",7,5,1,4,2,3,"N/A",4,6,4,4,5,19,23
"207","Western Sahara","Africa","t",2022,"NF",7,7,0,0,0,3,"N/A",-3,3,0,0,4,7,4
"208","Yemen","Middle East","c",2022,"NF",7,6,0,1,0,0,"N/A",1,2,3,1,2,8,9
"209","Zambia","Africa","c",2022,"PF",4,4,6,11,4,0,"N/A",21,8,6,8,8,30,51
"210","Zimbabwe","Africa","c",2022,"NF",6,5,3,5,3,0,"N/A",11,7,3,2,5,17,28
"211","Abkhazia","Eurasia","t",2021,"PF",5,5,5,8,4,0,"N/A",17,8,6,4,5,23,40
"212","Afghanistan","Asia","c",2021,"NF",5,6,3,7,3,0,"N/A",13,6,4,2,2,14,27
"213","Albania","Europe","c",2021,"PF",3,3,8,12,7,0,"N/A",27,13,8,9,9,39,66
"214","Algeria","Africa","c",2021,"NF",6,5,3,4,3,0,"N/A",10,6,3,6,7,22,32
"215","Andorra","Europe","c",2021,"F",1,1,12,15,11,0,"N/A",38,14,11,15,15,55,93
"216","Angola","Africa","c",2021,"NF",6,5,3,5,2,0,"N/A",10,7,6,5,3,21,31
"217","Antigua and Barbuda","Americas","c",2021,"F",2,2,12,13,8,0,"N/A",33,15,10,14,13,52,85
"218","Argentina","Americas","c",2021,"F",2,2,11,16,8,0,"N/A",35,15,11,10,13,49,84
"219","Armenia","Eurasia","c",2021,"PF",4,4,6,10,6,0,"N/A",22,9,8,6,10,33,55
"220","Australia","Asia","c",2021,"F",1,1,12,16,12,0,"N/A",40,15,12,15,15,57,97
"221","Austria","Europe","c",2021,"F",1,1,12,15,10,0,"N/A",37,14,12,15,15,56,93
"222","Azerbaijan","Eurasia","c",2021,"NF",7,6,0,2,0,0,"N/A",2,2,1,0,5,8,10
"223","Bahamas","Americas","c",2021,"F",1,1,12,16,10,0,"N/A",38,15,12,13,13,53,91
"224","Bahrain","Middle East","c",2021,"NF",7,6,2,0,2,2,"N/A",2,2,1,1,6,10,12
"225","Bangladesh","Asia","c",2021,"PF",5,5,4,7,4,0,"N/A",15,6,5,4,9,24,39
"226","Barbados","Americas","c",2021,"F",1,1,12,16,10,0,"N/A",38,16,12,14,15,57,95
"227","Belarus","Eurasia","c",2021,"NF",7,6,0,1,1,0,"N/A",2,2,1,1,5,9,11
"228","Belgium","Europe","c",2021,"F",1,1,12,16,11,0,"N/A",39,15,12,15,15,57,96
"229","Belize","Americas","c",2021,"F",2,1,12,14,8,0,"N/A",34,16,11,13,13,53,87
"230","Benin","Africa","c",2021,"PF",4,2,5,9,7,0,"N/A",21,14,9,11,10,44,65
"231","Bhutan","Asia","c",2021,"PF",2,4,10,12,9,1,"N/A",30,9,5,8,9,31,61
"232","Bolivia","Americas","c",2021,"PF",3,3,10,10,7,0,"N/A",27,14,9,6,10,39,66
"233","Bosnia and Herzegovina","Europe","c",2021,"PF",4,4,6,9,4,0,"N/A",19,10,7,7,10,34,53
"234","Botswana","Africa","c",2021,"F",3,2,10,10,8,0,"N/A",28,12,10,11,11,44,72
"235","Brazil","Americas","c",2021,"F",2,3,10,14,7,0,"N/A",31,14,9,8,12,43,74
"236","Brunei","Asia","c",2021,"NF",6,5,0,3,4,0,"N/A",7,6,3,5,7,21,28
"237","Bulgaria","Europe","c",2021,"F",2,2,11,14,8,0,"N/A",33,13,11,10,11,45,78
"238","Burkina Faso","Africa","c",2021,"PF",4,4,7,10,6,0,"N/A",23,11,8,5,7,31,54
"239","Burundi","Africa","c",2021,"NF",7,6,1,3,0,0,"N/A",4,4,1,1,4,10,14
"240","Cabo Verde","Africa","c",2021,"F",1,1,12,16,10,0,"N/A",38,16,11,14,13,54,92
"241","Cambodia","Asia","c",2021,"NF",7,5,1,2,2,0,"N/A",5,7,3,3,6,19,24
"242","Cameroon","Africa","c",2021,"NF",6,6,1,3,3,0,"N/A",7,4,2,0,3,9,16
"243","Canada","Americas","c",2021,"F",1,1,12,16,12,0,"N/A",40,15,12,15,16,58,98
"244","Central African Republic","Africa","c",2021,"NF",7,7,2,2,0,1,"N/A",3,4,1,1,0,6,9
"245","Chad","Africa","c",2021,"NF",7,6,1,1,1,0,"N/A",3,6,4,1,3,14,17
"246","Chile","Americas","c",2021,"F",1,1,12,15,11,0,"N/A",38,16,11,13,15,55,93
"247","China","Asia","c",2021,"NF",7,6,0,0,1,3,"N/A",-2,1,2,2,6,11,9
"248","Colombia","Americas","c",2021,"PF",3,3,10,11,8,0,"N/A",29,12,6,9,9,36,65
"249","Comoros","Africa","c",2021,"PF",5,4,5,7,4,0,"N/A",16,8,6,6,6,26,42
"250","Congo (Brazzaville)","Africa","c",2021,"NF",7,5,0,2,0,0,"N/A",2,7,4,1,6,18,20
"251","Congo (Kinshasa)","Africa","c",2021,"NF",7,6,1,2,2,0,"N/A",5,7,3,1,4,15,20
"252","Costa Rica","Americas","c",2021,"F",1,1,12,15,11,0,"N/A",38,16,11,13,13,53,91
"253","Cote d'Ivoire","Africa","c",2021,"PF",5,4,5,7,4,0,"N/A",16,9,6,6,7,28,44
"254","Crimea","Eurasia","t",2021,"NF",7,6,0,0,0,2,"N/A",-2,2,1,0,6,9,7
"255","Croatia","Europe","c",2021,"F",1,2,12,14,10,0,"N/A",36,13,12,11,13,49,85
"256","Cuba","Americas","c",2021,"NF",7,6,0,0,1,0,"N/A",1,4,0,2,6,12,13
"257","Cyprus","Europe","c",2021,"F",1,1,12,15,11,0,"N/A",38,15,12,15,14,56,94
"258","Czech Republic","Europe","c",2021,"F",1,1,12,15,9,0,"N/A",36,14,12,14,15,55,91
"259","Denmark","Europe","c",2021,"F",1,1,12,16,12,0,"N/A",40,16,12,14,15,57,97
"260","Djibouti","Africa","c",2021,"NF",7,5,2,3,0,0,"N/A",5,6,3,4,6,19,24
"261","Dominica","Americas","c",2021,"F",1,1,11,16,10,0,"N/A",37,15,11,15,15,56,93
"262","Dominican Republic","Americas","c",2021,"PF",3,3,9,10,7,0,"N/A",26,14,10,8,9,41,67
"263","Eastern Donbas","Eurasia","t",2021,"NF",7,7,0,0,0,1,"N/A",-1,2,0,0,3,5,4
"264","Ecuador","Americas","c",2021,"PF",3,3,8,12,7,0,"N/A",27,13,9,8,10,40,67
"265","Egypt","Africa","c",2021,"NF",6,6,2,2,2,0,"N/A",6,3,1,2,6,12,18
"266","El Salvador","Americas","c",2021,"PF",2,4,11,13,6,0,"N/A",30,11,8,7,7,33,63
"267","Equatorial Guinea","Africa","c",2021,"NF",7,7,0,0,0,0,"N/A",0,2,0,0,3,5,5
"268","Eritrea","Africa","c",2021,"NF",7,7,0,0,1,0,"N/A",1,0,0,0,1,1,2
"269","Estonia","Europe","c",2021,"F",1,1,12,15,11,0,"N/A",38,16,12,14,14,56,94
"270","Eswatini","Africa","c",2021,"NF",7,5,0,1,0,0,"N/A",1,5,3,5,5,18,19
"271","Ethiopia","Africa","c",2021,"NF",6,6,2,4,3,0,"N/A",9,4,4,2,3,13,22
"272","Fiji","Asia","c",2021,"PF",3,3,8,9,7,0,"N/A",24,12,7,7,10,36,60
"273","Finland","Europe","c",2021,"F",1,1,12,16,12,0,"N/A",40,16,12,16,16,60,100
"274","France","Europe","c",2021,"F",1,2,12,15,11,0,"N/A",38,14,11,13,14,52,90
"275","Gabon","Africa","c",2021,"NF",7,5,0,2,1,0,"N/A",3,8,3,3,5,19,22
"276","Gaza Strip","Middle East","t",2021,"NF",7,6,0,2,1,0,"N/A",3,4,2,0,2,8,11
"277","Georgia","Eurasia","c",2021,"PF",4,3,7,9,7,0,"N/A",23,10,7,8,12,37,60
"278","Germany","Europe","c",2021,"F",1,1,12,15,12,0,"N/A",39,14,12,14,15,55,94
"279","Ghana","Africa","c",2021,"F",2,2,12,13,10,0,"N/A",35,14,11,11,11,47,82
"280","Greece","Europe","c",2021,"F",1,2,12,15,10,0,"N/A",37,14,11,11,14,50,87
"281","Grenada","Americas","c",2021,"F",1,2,11,16,10,0,"N/A",37,15,11,13,13,52,89
"282","Guatemala","Americas","c",2021,"PF",4,4,7,10,4,0,"N/A",21,11,6,6,8,31,52
"283","Guinea","Africa","c",2021,"PF",5,5,4,7,3,0,"N/A",14,10,4,4,6,24,38
"284","Guinea-Bissau","Africa","c",2021,"PF",5,4,7,8,2,0,"N/A",17,10,7,5,5,27,44
"285","Guyana","Americas","c",2021,"F",2,3,9,13,8,0,"N/A",30,15,11,8,9,43,73
"286","Haiti","Americas","c",2021,"PF",5,5,4,7,4,0,"N/A",15,10,3,4,5,22,37
"287","Honduras","Americas","c",2021,"PF",4,5,7,8,4,0,"N/A",19,9,4,4,8,25,44
"288","Hong Kong","Asia","t",2021,"PF",5,3,2,7,6,0,"N/A",15,9,6,9,13,37,52
"289","Hungary","Europe","c",2021,"PF",3,3,9,11,6,0,"N/A",26,10,10,10,13,43,69
"290","Iceland","Europe","c",2021,"F",1,1,12,15,10,0,"N/A",37,15,12,15,15,57,94
"291","India","Asia","c",2021,"PF",2,4,12,13,9,0,"N/A",34,9,7,8,9,33,67
"292","Indian Kashmir","Asia","t",2021,"NF",6,5,2,3,2,0,"N/A",7,6,3,4,7,20,27
"293","Indonesia","Asia","c",2021,"PF",2,4,11,13,6,0,"N/A",30,9,6,5,9,29,59
"294","Iran","Middle East","c",2021,"NF",6,6,3,2,1,0,"N/A",6,2,1,3,4,10,16
"295","Iraq","Middle East","c",2021,"NF",5,6,8,7,2,1,"N/A",16,4,4,1,4,13,29
"296","Ireland","Europe","c",2021,"F",1,1,12,16,11,0,"N/A",39,16,12,14,16,58,97
"297","Israel","Middle East","c",2021,"F",2,3,12,13,8,0,"N/A",33,12,9,11,11,43,76
"298","Italy","Europe","c",2021,"F",1,1,12,14,10,0,"N/A",36,15,12,13,14,54,90
"299","Jamaica","Americas","c",2021,"F",2,2,12,13,9,0,"N/A",34,15,11,9,11,46,80
"300","Japan","Asia","c",2021,"F",1,1,12,16,12,0,"N/A",40,15,12,15,14,56,96
"301","Jordan","Middle East","c",2021,"NF",6,5,2,6,3,0,"N/A",11,7,1,7,8,23,34
"302","Kazakhstan","Eurasia","c",2021,"NF",7,5,1,3,1,0,"N/A",5,4,2,4,8,18,23
"303","Kenya","Africa","c",2021,"PF",4,4,6,8,5,0,"N/A",19,10,7,5,7,29,48
"304","Kiribati","Asia","c",2021,"F",1,1,12,15,10,0,"N/A",37,16,12,15,13,56,93
"305","Kosovo","Europe","c",2021,"PF",4,4,8,10,5,0,"N/A",23,9,8,6,8,31,54
"306","Kuwait","Middle East","c",2021,"PF",5,5,3,7,4,0,"N/A",14,6,4,7,6,23,37
"307","Kyrgyzstan","Eurasia","c",2021,"NF",7,5,2,3,0,1,"N/A",4,10,5,2,7,24,28
"308","Laos","Asia","c",2021,"NF",7,6,0,0,2,0,"N/A",2,3,0,2,6,11,13
"309","Latvia","Europe","c",2021,"F",1,2,12,15,10,0,"N/A",37,14,12,12,14,52,89
"310","Lebanon","Middle East","c",2021,"PF",5,4,5,7,1,0,"N/A",13,11,8,5,6,30,43
"311","Lesotho","Africa","c",2021,"PF",3,3,10,11,6,0,"N/A",27,12,7,8,9,36,63
"312","Liberia","Africa","c",2021,"PF",3,4,8,12,7,0,"N/A",27,11,7,6,9,33,60
"313","Libya","Africa","c",2021,"NF",7,6,0,1,0,0,"N/A",1,4,2,0,2,8,9
"314","Liechtenstein","Europe","c",2021,"F",2,1,10,13,10,0,"N/A",33,16,12,14,15,57,90
"315","Lithuania","Europe","c",2021,"F",1,2,12,16,10,0,"N/A",38,15,11,12,14,52,90
"316","Luxembourg","Europe","c",2021,"F",1,1,12,16,10,0,"N/A",38,16,12,15,16,59,97
"317","Madagascar","Africa","c",2021,"PF",3,4,9,11,7,0,"N/A",27,10,8,7,8,33,60
"318","Malawi","Africa","c",2021,"PF",3,3,9,12,8,0,"N/A",29,13,8,9,7,37,66
"319","Malaysia","Asia","c",2021,"PF",4,4,6,9,6,0,"N/A",21,8,6,7,9,30,51
"320","Maldives","Asia","c",2021,"PF",4,5,7,8,4,0,"N/A",19,3,5,6,7,21,40
"321","Mali","Africa","c",2021,"NF",6,5,2,5,2,0,"N/A",9,10,6,4,4,24,33
"322","Malta","Europe","c",2021,"F",2,1,12,14,9,0,"N/A",35,14,12,15,14,55,90
"323","Marshall Islands","Asia","c",2021,"F",1,1,12,16,10,0,"N/A",38,16,11,15,13,55,93
"324","Mauritania","Africa","c",2021,"PF",5,5,6,4,4,0,"N/A",14,9,4,4,4,21,35
"325","Mauritius","Africa","c",2021,"F",1,2,12,15,10,0,"N/A",37,14,11,13,12,50,87
"326","Mexico","Americas","c",2021,"PF",3,4,9,13,5,0,"N/A",27,13,7,5,9,34,61
"327","Micronesia","Asia","c",2021,"F",1,1,12,15,10,0,"N/A",37,16,11,15,13,55,92
"328","Moldova","Eurasia","c",2021,"PF",3,3,9,12,5,0,"N/A",26,12,8,6,9,35,61
"329","Monaco","Europe","c",2021,"F",3,1,8,10,8,0,"N/A",26,16,12,14,15,57,83
"330","Mongolia","Asia","c",2021,"F",1,2,11,16,9,0,"N/A",36,14,11,11,12,48,84
"331","Montenegro","Europe","c",2021,"PF",3,3,9,10,5,0,"N/A",24,10,9,9,11,39,63
"332","Morocco","Africa","c",2021,"PF",5,5,5,5,3,0,"N/A",13,7,5,5,7,24,37
"333","Mozambique","Africa","c",2021,"PF",5,4,3,7,4,0,"N/A",14,9,6,6,8,29,43
"334","Myanmar","Asia","c",2021,"NF",5,6,5,8,4,4,"N/A",13,5,5,1,4,15,28
"335","Nagorno-Karabakh","Eurasia","t",2021,"PF",5,5,7,7,3,1,"N/A",16,7,5,3,4,19,35
"336","Namibia","Africa","c",2021,"F",2,2,11,12,8,0,"N/A",31,14,11,11,10,46,77
"337","Nauru","Asia","c",2021,"F",2,3,12,14,8,0,"N/A",34,13,9,9,12,43,77
"338","Nepal","Asia","c",2021,"PF",3,4,10,10,5,0,"N/A",25,10,7,6,8,31,56
"339","Netherlands","Europe","c",2021,"F",1,1,12,16,12,0,"N/A",40,16,12,15,15,58,98
"340","New Zealand","Asia","c",2021,"F",1,1,12,16,12,0,"N/A",40,16,12,15,16,59,99
"341","Nicaragua","Americas","c",2021,"NF",6,5,3,4,3,0,"N/A",10,7,2,3,8,20,30
"342","Niger","Africa","c",2021,"PF",4,4,6,8,6,0,"N/A",20,10,6,6,6,28,48
"343","Nigeria","Africa","c",2021,"PF",4,5,6,10,5,0,"N/A",21,9,6,4,5,24,45
"344","North Korea","Asia","c",2021,"NF",7,7,0,0,0,0,"N/A",0,0,0,0,3,3,3
"345","North Macedonia","Europe","c",2021,"PF",3,3,9,11,7,0,"N/A",27,12,8,9,10,39,66
"346","Northern Cyprus","Europe","t",2021,"F",3,2,9,12,7,0,"N/A",28,15,11,13,11,50,78
"347","Norway","Europe","c",2021,"F",1,1,12,16,12,0,"N/A",40,16,12,16,16,60,100
"348","Oman","Middle East","c",2021,"NF",6,5,2,2,2,0,"N/A",6,5,3,4,5,17,23
"349","Pakistan","Asia","c",2021,"PF",5,5,5,6,4,0,"N/A",15,6,6,4,6,22,37
"350","Pakistani Kashmir","Asia","t",2021,"NF",6,5,4,4,3,2,"N/A",9,6,4,3,6,19,28
"351","Palau","Asia","c",2021,"F",1,1,12,15,10,0,"N/A",37,16,11,15,13,55,92
"352","Panama","Americas","c",2021,"F",2,2,12,15,8,0,"N/A",35,15,11,10,12,48,83
"353","Papua New Guinea","Asia","c",2021,"PF",4,3,7,13,3,0,"N/A",23,14,10,7,8,39,62
"354","Paraguay","Americas","c",2021,"PF",3,3,10,12,6,0,"N/A",28,12,8,7,10,37,65
"355","Peru","Americas","c",2021,"PF",3,3,10,13,6,0,"N/A",29,15,8,8,11,42,71
"356","Philippines","Asia","c",2021,"PF",3,4,9,10,6,0,"N/A",25,12,6,3,10,31,56
"357","Poland","Europe","c",2021,"F",2,2,10,16,8,0,"N/A",34,13,10,11,14,48,82
"358","Portugal","Europe","c",2021,"F",1,1,12,16,11,0,"N/A",39,16,12,14,15,57,96
"359","Qatar","Middle East","c",2021,"NF",6,5,2,2,3,0,"N/A",7,7,2,5,4,18,25
"360","Romania","Europe","c",2021,"F",2,2,12,14,9,0,"N/A",35,13,11,12,12,48,83
"361","Russia","Eurasia","c",2021,"NF",7,6,0,3,2,0,"N/A",5,3,3,2,7,15,20
"362","Rwanda","Africa","c",2021,"NF",6,6,2,2,4,0,"N/A",8,3,2,2,6,13,21
"363","Samoa","Asia","c",2021,"F",2,2,9,12,9,0,"N/A",30,14,11,14,12,51,81
"364","San Marino","Europe","c",2021,"F",1,1,12,15,11,0,"N/A",38,15,12,13,15,55,93
"365","Sao Tome and Principe","Africa","c",2021,"F",2,2,11,15,9,0,"N/A",35,15,11,12,11,49,84
"366","Saudi Arabia","Middle East","c",2021,"NF",7,7,0,0,1,0,"N/A",1,2,0,2,2,6,7
"367","Senegal","Africa","c",2021,"PF",3,3,9,12,8,0,"N/A",29,13,9,9,11,42,71
"368","Serbia","Europe","c",2021,"PF",4,3,7,10,5,0,"N/A",22,12,9,9,12,42,64
"369","Seychelles","Africa","c",2021,"F",2,3,12,13,9,0,"N/A",34,12,9,11,11,43,77
"370","Sierra Leone","Africa","c",2021,"PF",3,3,10,11,7,0,"N/A",28,12,6,9,10,37,65
"371","Singapore","Asia","c",2021,"PF",4,4,4,8,7,0,"N/A",19,8,3,7,11,29,48
"372","Slovakia","Europe","c",2021,"F",1,1,12,15,10,0,"N/A",37,15,12,12,14,53,90
"373","Slovenia","Europe","c",2021,"F",1,1,12,16,11,0,"N/A",39,15,12,15,14,56,95
"374","Solomon Islands","Asia","c",2021,"F",2,2,9,14,7,0,"N/A",30,16,10,11,12,49,79
"375","Somalia","Africa","c",2021,"NF",7,7,0,1,0,0,"N/A",1,3,3,0,0,6,7
"376","Somaliland","Africa","t",2021,"PF",4,5,5,9,4,0,"N/A",18,6,5,7,6,24,42
"377","South Africa","Africa","c",2021,"F",2,2,12,13,8,0,"N/A",33,15,12,9,10,46,79
"378","South Korea","Asia","c",2021,"F",2,2,11,13,9,0,"N/A",33,14,11,12,13,50,83
"379","South Ossetia","Eurasia","t",2021,"NF",7,6,2,2,0,2,"N/A",2,3,2,1,2,8,10
"380","South Sudan","Africa","c",2021,"NF",7,7,1,1,0,4,"N/A",-2,2,2,0,0,4,2
"381","Spain","Europe","c",2021,"F",1,1,12,16,9,0,"N/A",37,14,11,13,15,53,90
"382","Sri Lanka","Asia","c",2021,"PF",4,4,9,10,5,1,"N/A",23,8,9,8,8,33,56
"383","St. Kitts and Nevis","Americas","c",2021,"F",2,1,10,15,10,0,"N/A",35,16,12,13,13,54,89
"384","St. Lucia","Americas","c",2021,"F",1,1,11,16,10,0,"N/A",37,15,12,13,14,54,91
"385","St. Vincent and the Grenadines","Americas","c",2021,"F",1,1,11,15,10,0,"N/A",36,15,12,14,14,55,91
"386","Sudan","Africa","c",2021,"NF",7,6,0,4,0,2,"N/A",2,7,4,1,3,15,17
"387","Suriname","Americas","c",2021,"F",2,2,11,14,9,0,"N/A",34,15,11,9,10,45,79
"388","Sweden","Europe","c",2021,"F",1,1,12,16,12,0,"N/A",40,16,12,16,16,60,100
"389","Switzerland","Europe","c",2021,"F",1,1,12,15,12,0,"N/A",39,15,12,15,15,57,96
"390","Syria","Middle East","c",2021,"NF",7,7,0,0,0,3,"N/A",-3,3,0,0,1,4,1
"391","Taiwan","Asia","c",2021,"F",1,1,12,15,11,0,"N/A",38,16,11,15,14,56,94
"392","Tajikistan","Eurasia","c",2021,"NF",7,6,0,0,0,0,"N/A",0,1,2,1,4,8,8
"393","Tanzania","Africa","c",2021,"PF",5,5,3,5,4,0,"N/A",12,7,4,4,7,22,34
"394","Thailand","Asia","c",2021,"NF",7,5,1,2,2,0,"N/A",5,6,4,5,10,25,30
"395","The Gambia","Africa","c",2021,"PF",4,4,7,9,4,0,"N/A",20,8,6,6,6,26,46
"396","Tibet","Asia","t",2021,"NF",7,7,0,0,1,3,"N/A",-2,0,0,0,3,3,1
"397","Timor-Leste","Asia","c",2021,"F",2,3,11,14,8,0,"N/A",33,14,8,8,9,39,72
"398","Togo","Africa","c",2021,"PF",5,4,4,6,5,0,"N/A",15,9,6,6,7,28,43
"399","Tonga","Asia","c",2021,"F",2,2,9,14,7,0,"N/A",30,14,10,12,13,49,79
"400","Transnistria","Eurasia","t",2021,"NF",6,6,2,4,2,0,"N/A",8,4,1,2,5,12,20
"401","Trinidad and Tobago","Americas","c",2021,"F",2,2,11,13,9,0,"N/A",33,16,11,9,13,49,82
"402","Tunisia","Africa","c",2021,"F",2,3,12,14,6,0,"N/A",32,12,8,9,10,39,71
"403","Turkey","Europe","c",2021,"NF",5,6,5,8,3,0,"N/A",16,5,3,3,5,16,32
"404","Turkmenistan","Eurasia","c",2021,"NF",7,7,0,0,0,0,"N/A",0,0,0,0,2,2,2
"405","Tuvalu","Asia","c",2021,"F",1,1,12,15,10,0,"N/A",37,16,12,15,13,56,93
"406","Uganda","Africa","c",2021,"NF",6,5,3,5,3,0,"N/A",11,8,4,4,7,23,34
"407","Ukraine","Eurasia","c",2021,"PF",3,4,9,12,5,0,"N/A",26,11,7,6,10,34,60
"408","United Arab Emirates","Middle East","c",2021,"NF",7,6,1,2,2,0,"N/A",5,3,2,3,4,12,17
"409","United Kingdom","Europe","c",2021,"F",1,1,12,16,11,0,"N/A",39,14,12,13,15,54,93
"410","United States","Americas","c",2021,"F",2,2,10,14,8,0,"N/A",32,15,10,11,15,51,83
"411","Uruguay","Americas","c",2021,"F",1,1,12,16,12,0,"N/A",40,16,12,15,15,58,98
"412","Uzbekistan","Eurasia","c",2021,"NF",7,6,1,0,1,0,"N/A",2,3,1,1,4,9,11
"413","Vanuatu","Asia","c",2021,"F",2,2,10,15,8,0,"N/A",33,14,11,13,11,49,82
"414","Venezuela","Americas","c",2021,"NF",7,6,0,1,0,0,"N/A",1,6,2,1,4,13,14
"415","Vietnam","Asia","c",2021,"NF",7,6,0,1,2,0,"N/A",3,3,1,4,8,16,19
"416","West Bank","Middle East","t",2021,"NF",7,5,1,4,2,3,"N/A",4,7,5,4,5,21,25
"417","Western Sahara","Africa","t",2021,"NF",7,7,0,0,0,3,"N/A",-3,3,0,0,4,7,4
"418","Yemen","Middle East","c",2021,"NF",7,6,0,1,0,0,"N/A",1,3,3,2,2,10,11
"419","Zambia","Africa","c",2021,"PF",4,4,6,10,4,0,"N/A",20,9,7,8,8,32,52
"420","Zimbabwe","Africa","c",2021,"NF",6,5,3,5,3,0,"N/A",11,7,3,2,5,17,28
"421","Abkhazia","Eurasia","t",2020,"PF",5,5,5,8,4,0,"N/A",17,8,6,4,5,23,40
"422","Afghanistan","Asia","c",2020,"NF",5,6,3,7,3,0,"N/A",13,6,4,2,2,14,27
"423","Albania","Europe","c",2020,"PF",3,3,8,12,7,0,"N/A",27,13,9,9,9,40,67
"424","Algeria","Africa","c",2020,"NF",6,5,3,4,3,0,"N/A",10,7,4,6,7,24,34
"425","Andorra","Europe","c",2020,"F",1,1,12,15,12,0,"N/A",39,14,11,15,15,55,94
"426","Angola","Africa","c",2020,"NF",6,5,3,6,2,0,"N/A",11,7,6,5,3,21,32
"427","Antigua and Barbuda","Americas","c",2020,"F",2,2,12,13,8,0,"N/A",33,15,10,14,13,52,85
"428","Argentina","Americas","c",2020,"F",2,2,11,16,8,0,"N/A",35,15,11,10,14,50,85
"429","Armenia","Eurasia","c",2020,"PF",4,4,6,10,5,0,"N/A",21,9,8,6,9,32,53
"430","Australia","Asia","c",2020,"F",1,1,12,16,12,0,"N/A",40,15,12,15,15,57,97
"431","Austria","Europe","c",2020,"F",1,1,12,15,10,0,"N/A",37,14,12,15,15,56,93
"432","Azerbaijan","Eurasia","c",2020,"NF",7,6,0,2,0,0,"N/A",2,2,1,0,5,8,10
"433","Bahamas","Americas","c",2020,"F",1,1,12,16,10,0,"N/A",38,15,12,13,13,53,91
"434","Bahrain","Middle East","c",2020,"NF",7,6,2,0,2,3,"N/A",1,2,1,1,6,10,11
"435","Bangladesh","Asia","c",2020,"PF",5,5,4,7,4,0,"N/A",15,6,5,4,9,24,39
"436","Barbados","Americas","c",2020,"F",1,1,12,16,10,0,"N/A",38,16,12,14,15,57,95
"437","Belarus","Eurasia","c",2020,"NF",7,6,0,3,2,0,"N/A",5,2,3,2,7,14,19
"438","Belgium","Europe","c",2020,"F",1,1,12,16,11,0,"N/A",39,15,12,15,15,57,96
"439","Belize","Americas","c",2020,"F",2,2,12,14,9,0,"N/A",35,15,11,12,13,51,86
"440","Benin","Africa","c",2020,"PF",4,2,5,9,7,0,"N/A",21,15,9,11,10,45,66
"441","Bhutan","Asia","c",2020,"PF",3,4,10,11,9,1,"N/A",29,9,5,8,8,30,59
"442","Bolivia","Americas","c",2020,"PF",3,3,8,10,7,0,"N/A",25,14,8,6,10,38,63
"443","Bosnia and Herzegovina","Europe","c",2020,"PF",4,4,6,9,4,0,"N/A",19,10,7,7,10,34,53
"444","Botswana","Africa","c",2020,"F",3,2,10,10,8,0,"N/A",28,12,10,11,11,44,72
"445","Brazil","Americas","c",2020,"F",2,2,10,14,7,0,"N/A",31,14,9,8,13,44,75
"446","Brunei","Asia","c",2020,"NF",6,5,0,3,4,0,"N/A",7,6,3,5,7,21,28
"447","Bulgaria","Europe","c",2020,"F",2,2,11,14,9,0,"N/A",34,13,11,10,12,46,80
"448","Burkina Faso","Africa","c",2020,"PF",4,4,7,10,6,0,"N/A",23,11,8,6,8,33,56
"449","Burundi","Africa","c",2020,"NF",7,6,0,3,0,0,"N/A",3,4,1,1,4,10,13
"450","Cabo Verde","Africa","c",2020,"F",1,1,12,16,10,0,"N/A",38,16,11,14,13,54,92
"451","Cambodia","Asia","c",2020,"NF",7,5,1,2,2,0,"N/A",5,8,3,3,6,20,25
"452","Cameroon","Africa","c",2020,"NF",6,6,1,3,3,0,"N/A",7,4,2,1,4,11,18
"453","Canada","Americas","c",2020,"F",1,1,12,16,12,0,"N/A",40,15,12,15,16,58,98
"454","Central African Republic","Africa","c",2020,"NF",7,7,3,2,0,1,"N/A",4,4,1,1,0,6,10
"455","Chad","Africa","c",2020,"NF",7,6,1,1,1,0,"N/A",3,6,4,1,3,14,17
"456","Chile","Americas","c",2020,"F",1,2,12,15,11,0,"N/A",38,15,10,13,14,52,90
"457","China","Asia","c",2020,"NF",7,6,0,0,2,3,"N/A",-1,1,2,2,6,11,10
"458","Colombia","Americas","c",2020,"PF",3,3,10,11,8,0,"N/A",29,12,6,9,10,37,66
"459","Comoros","Africa","c",2020,"PF",4,4,6,8,4,0,"N/A",18,8,6,6,6,26,44
"460","Congo (Brazzaville)","Africa","c",2020,"NF",7,5,0,2,0,0,"N/A",2,7,4,1,6,18,20
"461","Congo (Kinshasa)","Africa","c",2020,"NF",7,6,1,2,1,0,"N/A",4,7,3,0,4,14,18
"462","Costa Rica","Americas","c",2020,"F",1,1,12,15,11,0,"N/A",38,16,11,13,13,53,91
"463","Cote d'Ivoire","Africa","c",2020,"PF",4,4,7,8,4,0,"N/A",19,11,8,6,7,32,51
"464","Crimea","Eurasia","t",2020,"NF",7,6,0,0,0,2,"N/A",-2,3,1,0,6,10,8
"465","Croatia","Europe","c",2020,"F",1,2,12,14,10,0,"N/A",36,13,12,11,13,49,85
"466","Cuba","Americas","c",2020,"NF",7,6,0,0,1,0,"N/A",1,5,0,2,6,13,14
"467","Cyprus","Europe","c",2020,"F",1,1,12,15,11,0,"N/A",38,15,12,15,14,56,94
"468","Czech Republic","Europe","c",2020,"F",1,1,12,15,9,0,"N/A",36,14,12,14,15,55,91
"469","Denmark","Europe","c",2020,"F",1,1,12,16,12,0,"N/A",40,16,12,14,15,57,97
"470","Djibouti","Africa","c",2020,"NF",7,5,2,3,0,0,"N/A",5,6,3,4,6,19,24
"471","Dominica","Americas","c",2020,"F",1,1,11,16,10,0,"N/A",37,15,11,15,15,56,93
"472","Dominican Republic","Americas","c",2020,"PF",3,3,9,10,7,0,"N/A",26,14,10,8,9,41,67
"473","Eastern Donbas","Eurasia","t",2020,"NF",7,7,0,0,0,1,"N/A",-1,2,0,0,4,6,5
"474","Ecuador","Americas","c",2020,"PF",3,3,8,12,7,0,"N/A",27,12,8,8,10,38,65
"475","Egypt","Africa","c",2020,"NF",6,6,2,3,2,0,"N/A",7,4,1,3,6,14,21
"476","El Salvador","Americas","c",2020,"PF",2,4,11,13,8,0,"N/A",32,11,8,7,8,34,66
"477","Equatorial Guinea","Africa","c",2020,"NF",7,7,0,0,0,0,"N/A",0,3,0,0,3,6,6
"478","Eritrea","Africa","c",2020,"NF",7,7,0,0,1,0,"N/A",1,0,0,0,1,1,2
"479","Estonia","Europe","c",2020,"F",1,1,12,15,11,0,"N/A",38,16,12,14,14,56,94
"480","Eswatini","Africa","c",2020,"NF",7,5,0,1,0,0,"N/A",1,5,3,5,5,18,19
"481","Ethiopia","Africa","c",2020,"NF",6,6,2,5,3,0,"N/A",10,4,4,2,4,14,24
"482","Fiji","Asia","c",2020,"PF",3,3,8,9,7,0,"N/A",24,12,7,7,10,36,60
"483","Finland","Europe","c",2020,"F",1,1,12,16,12,0,"N/A",40,16,12,16,16,60,100
"484","France","Europe","c",2020,"F",1,2,12,15,11,0,"N/A",38,14,11,13,14,52,90
"485","Gabon","Africa","c",2020,"NF",7,5,0,2,1,0,"N/A",3,8,3,3,5,19,22
"486","Gaza Strip","Middle East","t",2020,"NF",7,6,0,2,1,0,"N/A",3,4,2,0,2,8,11
"487","Georgia","Eurasia","c",2020,"PF",3,3,8,9,7,0,"N/A",24,10,7,8,12,37,61
"488","Germany","Europe","c",2020,"F",1,1,12,15,12,0,"N/A",39,14,12,14,15,55,94
"489","Ghana","Africa","c",2020,"F",2,2,12,13,10,0,"N/A",35,14,11,11,11,47,82
"490","Greece","Europe","c",2020,"F",1,2,12,15,10,0,"N/A",37,14,12,11,14,51,88
"491","Grenada","Americas","c",2020,"F",1,2,11,16,10,0,"N/A",37,15,11,13,13,52,89
"492","Guatemala","Americas","c",2020,"PF",4,4,7,10,4,0,"N/A",21,11,6,6,8,31,52
"493","Guinea","Africa","c",2020,"PF",5,5,5,7,3,0,"N/A",15,11,4,4,6,25,40
"494","Guinea-Bissau","Africa","c",2020,"PF",5,4,7,8,2,0,"N/A",17,11,8,5,5,29,46
"495","Guyana","Americas","c",2020,"F",2,3,10,13,8,0,"N/A",31,15,11,8,9,43,74
"496","Haiti","Americas","c",2020,"PF",5,5,5,7,4,0,"N/A",16,10,3,4,5,22,38
"497","Honduras","Americas","c",2020,"PF",4,4,7,8,4,0,"N/A",19,9,4,5,8,26,45
"498","Hong Kong","Asia","t",2020,"PF",5,3,2,8,6,0,"N/A",16,10,6,10,13,39,55
"499","Hungary","Europe","c",2020,"PF",3,3,9,11,7,0,"N/A",27,10,10,10,13,43,70
"500","Iceland","Europe","c",2020,"F",1,1,12,15,10,0,"N/A",37,15,12,15,15,57,94
"501","India","Asia","c",2020,"F",2,3,12,13,9,0,"N/A",34,10,8,9,10,37,71
"502","Indian Kashmir","Asia","t",2020,"NF",6,5,2,4,2,0,"N/A",8,6,3,4,7,20,28
"503","Indonesia","Asia","c",2020,"PF",2,4,11,13,6,0,"N/A",30,10,7,5,9,31,61
"504","Iran","Middle East","c",2020,"NF",6,6,3,2,2,0,"N/A",7,2,1,3,4,10,17
"505","Iraq","Middle East","c",2020,"NF",5,6,8,8,2,1,"N/A",17,5,4,1,4,14,31
"506","Ireland","Europe","c",2020,"F",1,1,12,16,11,0,"N/A",39,16,12,14,16,58,97
"507","Israel","Middle East","c",2020,"F",2,3,12,13,8,0,"N/A",33,12,9,11,11,43,76
"508","Italy","Europe","c",2020,"F",1,1,12,14,10,0,"N/A",36,15,12,12,14,53,89
"509","Jamaica","Americas","c",2020,"F",2,2,12,13,9,0,"N/A",34,15,10,8,11,44,78
"510","Japan","Asia","c",2020,"F",1,1,12,16,12,0,"N/A",40,15,12,15,14,56,96
"511","Jordan","Middle East","c",2020,"PF",5,5,3,6,3,0,"N/A",12,7,3,7,8,25,37
"512","Kazakhstan","Eurasia","c",2020,"NF",7,5,1,3,1,0,"N/A",5,4,2,4,8,18,23
"513","Kenya","Africa","c",2020,"PF",4,4,6,8,5,0,"N/A",19,10,7,5,7,29,48
"514","Kiribati","Asia","c",2020,"F",1,1,12,15,10,0,"N/A",37,16,12,15,13,56,93
"515","Kosovo","Europe","c",2020,"PF",3,4,9,11,5,0,"N/A",25,9,8,6,8,31,56
"516","Kuwait","Middle East","c",2020,"PF",5,5,2,7,4,0,"N/A",13,6,4,7,6,23,36
"517","Kyrgyzstan","Eurasia","c",2020,"PF",5,4,4,5,4,1,"N/A",12,10,6,4,7,27,39
"518","Laos","Asia","c",2020,"NF",7,6,0,0,2,0,"N/A",2,4,0,2,6,12,14
"519","Latvia","Europe","c",2020,"F",1,2,12,15,10,0,"N/A",37,14,12,12,14,52,89
"520","Lebanon","Middle East","c",2020,"PF",5,4,5,7,2,0,"N/A",14,11,8,5,6,30,44
"521","Lesotho","Africa","c",2020,"PF",3,3,10,11,6,0,"N/A",27,12,7,8,9,36,63
"522","Liberia","Africa","c",2020,"PF",3,4,8,12,7,0,"N/A",27,11,7,6,9,33,60
"523","Libya","Africa","c",2020,"NF",7,6,0,1,0,0,"N/A",1,4,2,0,2,8,9
"524","Liechtenstein","Europe","c",2020,"F",2,1,10,13,10,0,"N/A",33,16,12,14,15,57,90
"525","Lithuania","Europe","c",2020,"F",1,1,12,16,10,0,"N/A",38,16,11,12,14,53,91
"526","Luxembourg","Europe","c",2020,"F",1,1,12,16,10,0,"N/A",38,16,12,16,16,60,98
"527","Madagascar","Africa","c",2020,"PF",3,3,9,11,6,0,"N/A",26,11,9,7,8,35,61
"528","Malawi","Africa","c",2020,"PF",3,3,8,12,6,0,"N/A",26,13,7,9,7,36,62
"529","Malaysia","Asia","c",2020,"PF",4,4,6,9,6,0,"N/A",21,9,6,7,9,31,52
"530","Maldives","Asia","c",2020,"PF",4,5,7,7,4,0,"N/A",18,3,6,6,7,22,40
"531","Mali","Africa","c",2020,"PF",5,5,5,8,4,0,"N/A",17,10,6,4,4,24,41
"532","Malta","Europe","c",2020,"F",2,1,12,14,9,0,"N/A",35,14,12,15,14,55,90
"533","Marshall Islands","Asia","c",2020,"F",1,1,12,16,10,0,"N/A",38,16,11,15,13,55,93
"534","Mauritania","Africa","c",2020,"PF",5,5,6,3,4,0,"N/A",13,9,4,4,4,21,34
"535","Mauritius","Africa","c",2020,"F",1,2,12,15,10,0,"N/A",37,15,12,13,12,52,89
"536","Mexico","Americas","c",2020,"PF",3,3,9,13,5,0,"N/A",27,13,7,5,10,35,62
"537","Micronesia","Asia","c",2020,"F",1,1,12,15,10,0,"N/A",37,16,11,15,13,55,92
"538","Moldova","Eurasia","c",2020,"PF",3,4,9,12,5,0,"N/A",26,11,8,6,9,34,60
"539","Monaco","Europe","c",2020,"F",3,1,8,10,8,0,"N/A",26,16,12,14,15,57,83
"540","Mongolia","Asia","c",2020,"F",1,2,11,16,9,0,"N/A",36,14,11,11,12,48,84
"541","Montenegro","Europe","c",2020,"PF",4,3,8,9,5,0,"N/A",22,11,9,9,11,40,62
"542","Morocco","Africa","c",2020,"PF",5,5,5,5,3,0,"N/A",13,7,5,5,7,24,37
"543","Mozambique","Africa","c",2020,"PF",5,4,3,7,4,0,"N/A",14,9,6,7,9,31,45
"544","Myanmar","Asia","c",2020,"NF",5,6,5,9,4,4,"N/A",14,5,6,1,4,16,30
"545","Nagorno-Karabakh","Eurasia","t",2020,"PF",5,5,4,6,3,0,"N/A",13,7,5,4,5,21,34
"546","Namibia","Africa","c",2020,"F",2,2,11,12,8,0,"N/A",31,14,11,11,10,46,77
"547","Nauru","Asia","c",2020,"F",2,3,12,14,8,0,"N/A",34,13,9,9,12,43,77
"548","Nepal","Asia","c",2020,"PF",3,4,10,10,5,0,"N/A",25,10,7,6,8,31,56
"549","Netherlands","Europe","c",2020,"F",1,1,12,16,12,0,"N/A",40,16,12,15,16,59,99
"550","New Zealand","Asia","c",2020,"F",1,1,12,16,12,0,"N/A",40,16,12,14,15,57,97
"551","Nicaragua","Americas","c",2020,"NF",6,5,3,4,3,0,"N/A",10,7,2,4,8,21,31
"552","Niger","Africa","c",2020,"PF",4,4,6,8,6,0,"N/A",20,10,6,6,6,28,48
"553","Nigeria","Africa","c",2020,"PF",4,5,6,10,6,0,"N/A",22,9,7,4,5,25,47
"554","North Korea","Asia","c",2020,"NF",7,7,0,0,0,0,"N/A",0,0,0,0,3,3,3
"555","North Macedonia","Europe","c",2020,"PF",3,3,7,11,6,0,"N/A",24,12,8,9,10,39,63
"556","Northern Cyprus","Europe","t",2020,"F",2,2,11,13,7,0,"N/A",31,15,11,13,11,50,81
"557","Norway","Europe","c",2020,"F",1,1,12,16,12,0,"N/A",40,16,12,16,16,60,100
"558","Oman","Middle East","c",2020,"NF",6,5,2,2,2,0,"N/A",6,5,3,4,5,17,23
"559","Pakistan","Asia","c",2020,"PF",5,5,5,6,5,0,"N/A",16,6,6,4,6,22,38
"560","Pakistani Kashmir","Asia","t",2020,"NF",6,5,4,4,3,2,"N/A",9,6,4,3,6,19,28
"561","Palau","Asia","c",2020,"F",1,1,12,15,10,0,"N/A",37,16,11,15,13,55,92
"562","Panama","Americas","c",2020,"F",1,2,12,15,9,0,"N/A",36,15,11,10,12,48,84
"563","Papua New Guinea","Asia","c",2020,"PF",4,3,7,13,3,0,"N/A",23,14,10,7,8,39,62
"564","Paraguay","Americas","c",2020,"PF",3,3,10,12,6,0,"N/A",28,12,8,7,10,37,65
"565","Peru","Americas","c",2020,"F",2,3,11,13,6,0,"N/A",30,15,8,8,11,42,72
"566","Philippines","Asia","c",2020,"PF",3,4,9,10,6,0,"N/A",25,14,7,3,10,34,59
"567","Poland","Europe","c",2020,"F",2,2,11,16,8,0,"N/A",35,14,10,11,14,49,84
"568","Portugal","Europe","c",2020,"F",1,1,12,16,11,0,"N/A",39,16,12,14,15,57,96
"569","Qatar","Middle East","c",2020,"NF",6,5,2,2,3,0,"N/A",7,7,2,5,4,18,25
"570","Romania","Europe","c",2020,"F",2,2,12,14,9,0,"N/A",35,13,11,12,12,48,83
"571","Russia","Eurasia","c",2020,"NF",7,6,0,3,2,0,"N/A",5,3,3,2,7,15,20
"572","Rwanda","Africa","c",2020,"NF",6,6,2,2,4,0,"N/A",8,3,2,2,7,14,22
"573","Samoa","Asia","c",2020,"F",2,2,9,12,9,0,"N/A",30,14,11,14,12,51,81
"574","San Marino","Europe","c",2020,"F",1,1,12,15,11,0,"N/A",38,15,12,15,15,57,95
"575","Sao Tome and Principe","Africa","c",2020,"F",2,2,11,15,9,0,"N/A",35,15,11,12,11,49,84
"576","Saudi Arabia","Middle East","c",2020,"NF",7,7,0,0,1,0,"N/A",1,2,0,2,2,6,7
"577","Senegal","Africa","c",2020,"PF",3,3,9,12,8,0,"N/A",29,13,9,9,11,42,71
"578","Serbia","Europe","c",2020,"PF",4,3,8,10,5,0,"N/A",23,12,10,9,12,43,66
"579","Seychelles","Africa","c",2020,"PF",3,3,10,11,8,0,"N/A",29,12,9,11,11,43,72
"580","Sierra Leone","Africa","c",2020,"PF",3,3,10,11,7,0,"N/A",28,12,6,9,10,37,65
"581","Singapore","Asia","c",2020,"PF",4,4,4,8,7,0,"N/A",19,8,4,7,12,31,50
"582","Slovakia","Europe","c",2020,"F",1,2,12,15,9,0,"N/A",36,14,12,12,14,52,88
"583","Slovenia","Europe","c",2020,"F",1,1,12,16,11,0,"N/A",39,14,12,15,14,55,94
"584","Solomon Islands","Asia","c",2020,"F",2,2,9,14,7,0,"N/A",30,16,10,11,12,49,79
"585","Somalia","Africa","c",2020,"NF",7,7,0,1,0,0,"N/A",1,3,3,0,0,6,7
"586","Somaliland","Africa","t",2020,"PF",5,5,5,8,4,0,"N/A",17,6,5,7,6,24,41
"587","South Africa","Africa","c",2020,"F",2,2,12,13,8,0,"N/A",33,15,12,9,10,46,79
"588","South Korea","Asia","c",2020,"F",2,2,11,13,9,0,"N/A",33,14,11,12,13,50,83
"589","South Ossetia","Eurasia","t",2020,"NF",7,6,2,2,0,2,"N/A",2,3,1,1,3,8,10
"590","South Sudan","Africa","c",2020,"NF",7,7,1,1,0,4,"N/A",-2,2,2,0,0,4,2
"591","Spain","Europe","c",2020,"F",1,1,12,16,10,0,"N/A",38,14,11,14,15,54,92
"592","Sri Lanka","Asia","c",2020,"PF",4,4,9,10,5,1,"N/A",23,8,9,8,8,33,56
"593","St. Kitts and Nevis","Americas","c",2020,"F",1,1,10,16,10,0,"N/A",36,15,12,13,13,53,89
"594","St. Lucia","Americas","c",2020,"F",1,1,11,16,11,0,"N/A",38,15,12,13,14,54,92
"595","St. Vincent and the Grenadines","Americas","c",2020,"F",1,1,11,15,10,0,"N/A",36,15,12,14,14,55,91
"596","Sudan","Africa","c",2020,"NF",7,6,0,4,0,2,"N/A",2,5,3,1,1,10,12
"597","Suriname","Americas","c",2020,"F",2,3,11,14,7,0,"N/A",32,14,11,8,10,43,75
"598","Sweden","Europe","c",2020,"F",1,1,12,16,12,0,"N/A",40,16,12,16,16,60,100
"599","Switzerland","Europe","c",2020,"F",1,1,12,15,12,0,"N/A",39,15,12,15,15,57,96
"600","Syria","Middle East","c",2020,"NF",7,7,0,0,0,3,"N/A",-3,3,0,0,0,3,0
"601","Taiwan","Asia","c",2020,"F",1,1,12,15,10,0,"N/A",37,16,11,15,14,56,93
"602","Tajikistan","Eurasia","c",2020,"NF",7,6,0,0,0,0,"N/A",0,2,2,1,4,9,9
"603","Tanzania","Africa","c",2020,"PF",5,5,6,6,5,0,"N/A",17,7,4,5,7,23,40
"604","Thailand","Asia","c",2020,"PF",6,4,1,3,2,0,"N/A",6,6,5,5,10,26,32
"605","The Gambia","Africa","c",2020,"PF",4,4,7,9,4,0,"N/A",20,8,6,6,6,26,46
"606","Tibet","Asia","t",2020,"NF",7,7,0,0,1,3,"N/A",-2,0,0,0,3,3,1
"607","Timor-Leste","Asia","c",2020,"F",2,3,11,14,7,0,"N/A",32,14,8,8,9,39,71
"608","Togo","Africa","c",2020,"PF",5,4,5,6,5,0,"N/A",16,9,6,6,7,28,44
"609","Tonga","Asia","c",2020,"F",2,2,9,14,7,0,"N/A",30,14,10,12,13,49,79
"610","Transnistria","Eurasia","t",2020,"NF",6,6,3,4,2,0,"N/A",9,5,1,2,5,13,22
"611","Trinidad and Tobago","Americas","c",2020,"F",2,2,11,13,9,0,"N/A",33,16,11,9,13,49,82
"612","Tunisia","Africa","c",2020,"F",2,3,12,14,6,0,"N/A",32,12,7,9,10,38,70
"613","Turkey","Europe","c",2020,"NF",5,6,5,8,3,0,"N/A",16,5,3,3,5,16,32
"614","Turkmenistan","Eurasia","c",2020,"NF",7,7,0,0,0,0,"N/A",0,0,0,0,2,2,2
"615","Tuvalu","Asia","c",2020,"F",1,1,12,15,10,0,"N/A",37,16,12,15,13,56,93
"616","Uganda","Africa","c",2020,"NF",6,5,3,5,3,0,"N/A",11,8,4,4,7,23,34
"617","Ukraine","Eurasia","c",2020,"PF",3,3,9,12,6,0,"N/A",27,11,7,7,10,35,62
"618","United Arab Emirates","Middle East","c",2020,"NF",7,6,1,2,2,0,"N/A",5,3,2,3,4,12,17
"619","United Kingdom","Europe","c",2020,"F",1,1,12,16,11,0,"N/A",39,14,12,14,15,55,94
"620","United States","Americas","c",2020,"F",2,1,10,14,9,0,"N/A",33,16,11,11,15,53,86
"621","Uruguay","Americas","c",2020,"F",1,1,12,16,12,0,"N/A",40,16,12,15,15,58,98
"622","Uzbekistan","Eurasia","c",2020,"NF",7,6,1,0,1,0,"N/A",2,2,1,1,4,8,10
"623","Vanuatu","Asia","c",2020,"F",2,2,10,15,8,0,"N/A",33,14,11,13,11,49,82
"624","Venezuela","Americas","c",2020,"NF",7,6,0,2,0,0,"N/A",2,6,2,1,5,14,16
"625","Vietnam","Asia","c",2020,"NF",7,5,0,1,2,0,"N/A",3,4,1,4,8,17,20
"626","West Bank","Middle East","t",2020,"NF",7,5,1,4,2,3,"N/A",4,7,5,4,5,21,25
"627","Western Sahara","Africa","t",2020,"NF",7,7,0,0,0,3,"N/A",-3,3,0,0,4,7,4
"628","Yemen","Middle East","c",2020,"NF",7,6,0,1,0,0,"N/A",1,3,3,2,2,10,11
"629","Zambia","Africa","c",2020,"PF",4,4,6,10,6,0,"N/A",22,9,7,8,8,32,54
"630","Zimbabwe","Africa","c",2020,"PF",5,5,3,6,3,0,"N/A",12,7,3,2,5,17,29
"631","Abkhazia","Eurasia","t",2019,"PF",4,5,6,8,4,0,"N/A",18,8,6,4,5,23,41
"632","Afghanistan","Asia","c",2019,"NF",5,6,3,7,3,0,"N/A",13,6,4,2,2,14,27
"633","Albania","Europe","c",2019,"PF",3,3,8,13,7,0,"N/A",28,13,9,9,9,40,68
"634","Algeria","Africa","c",2019,"NF",6,5,3,4,3,0,"N/A",10,7,4,6,7,24,34
"635","Andorra","Europe","c",2019,"F",1,1,12,15,12,0,"N/A",39,14,11,15,15,55,94
"636","Angola","Africa","c",2019,"NF",6,5,3,6,2,0,"N/A",11,7,6,4,3,20,31
"637","Antigua and Barbuda","Americas","c",2019,"F",2,2,12,13,8,0,"N/A",33,15,9,14,13,51,84
"638","Argentina","Americas","c",2019,"F",2,2,11,15,8,0,"N/A",34,15,11,10,14,50,84
"639","Armenia","Eurasia","c",2019,"PF",4,4,6,10,4,0,"N/A",20,9,7,6,9,31,51
"640","Australia","Asia","c",2019,"F",1,1,12,16,12,0,"N/A",40,16,12,15,15,58,98
"641","Austria","Europe","c",2019,"F",1,1,12,15,10,0,"N/A",37,14,12,15,15,56,93
"642","Azerbaijan","Eurasia","c",2019,"NF",7,6,0,2,0,0,"N/A",2,2,1,1,5,9,11
"643","Bahamas","Americas","c",2019,"F",1,1,12,16,10,0,"N/A",38,15,12,13,13,53,91
"644","Bahrain","Middle East","c",2019,"NF",7,6,2,0,3,3,"N/A",2,2,1,1,6,10,12
"645","Bangladesh","Asia","c",2019,"PF",5,5,5,7,5,0,"N/A",17,6,5,4,9,24,41
"646","Barbados","Americas","c",2019,"F",1,1,12,16,10,0,"N/A",38,16,12,15,15,58,96
"647","Belarus","Eurasia","c",2019,"NF",7,6,0,3,2,0,"N/A",5,2,3,2,7,14,19
"648","Belgium","Europe","c",2019,"F",1,1,12,16,11,0,"N/A",39,15,12,15,15,57,96
"649","Belize","Americas","c",2019,"F",1,2,12,14,10,0,"N/A",36,15,10,12,13,50,86
"650","Benin","Africa","c",2019,"F",2,2,9,15,8,0,"N/A",32,15,11,11,10,47,79
"651","Bhutan","Asia","c",2019,"PF",3,4,10,11,9,1,"N/A",29,9,5,8,8,30,59
"652","Bolivia","Americas","c",2019,"PF",3,3,10,11,7,0,"N/A",28,14,9,6,10,39,67
"653","Bosnia and Herzegovina","Europe","c",2019,"PF",4,4,6,9,4,0,"N/A",19,10,7,7,10,34,53
"654","Botswana","Africa","c",2019,"F",3,2,10,10,8,0,"N/A",28,12,10,11,11,44,72
"655","Brazil","Americas","c",2019,"F",2,2,10,14,6,0,"N/A",30,15,9,8,13,45,75
"656","Brunei","Asia","c",2019,"NF",6,5,0,3,4,0,"N/A",7,6,3,6,7,22,29
"657","Bulgaria","Europe","c",2019,"F",2,2,11,14,8,0,"N/A",33,14,11,10,12,47,80
"658","Burkina Faso","Africa","c",2019,"PF",4,3,7,10,6,0,"N/A",23,13,9,7,8,37,60
"659","Burundi","Africa","c",2019,"NF",7,6,0,3,0,0,"N/A",3,5,1,1,4,11,14
"660","Cambodia","Asia","c",2019,"NF",6,5,1,2,3,0,"N/A",6,8,3,3,6,20,26
"661","Cameroon","Africa","c",2019,"NF",6,6,1,3,3,0,"N/A",7,5,2,1,4,12,19
"662","Canada","Americas","c",2019,"F",1,1,12,16,12,0,"N/A",40,16,12,15,16,59,99
"663","Cape Verde","Africa","c",2019,"F",1,1,12,15,10,0,"N/A",37,15,11,14,13,53,90
"664","Central African Republic","Africa","c",2019,"NF",7,7,3,2,0,1,"N/A",4,4,1,0,0,5,9
"665","Chad","Africa","c",2019,"NF",7,6,1,1,1,0,"N/A",3,6,4,1,3,14,17
"666","Chile","Americas","c",2019,"F",1,1,12,15,10,0,"N/A",37,16,12,14,15,57,94
"667","China","Asia","c",2019,"NF",7,6,0,0,2,3,"N/A",-1,2,2,2,6,12,11
"668","Colombia","Americas","c",2019,"PF",3,3,10,11,8,0,"N/A",29,12,6,9,10,37,66
"669","Comoros","Africa","c",2019,"PF",4,4,8,9,4,0,"N/A",21,10,6,7,6,29,50
"670","Congo (Brazzaville)","Africa","c",2019,"NF",7,5,0,2,0,0,"N/A",2,7,5,1,6,19,21
"671","Congo (Kinshasa)","Africa","c",2019,"NF",7,6,0,2,1,0,"N/A",3,7,1,0,4,12,15
"672","Costa Rica","Americas","c",2019,"F",1,1,12,15,11,0,"N/A",38,16,11,13,13,53,91
"673","Cote d'Ivoire","Africa","c",2019,"PF",4,4,7,8,4,0,"N/A",19,11,8,6,7,32,51
"674","Crimea","Eurasia","t",2019,"NF",7,6,0,0,0,2,"N/A",-2,3,1,0,6,10,8
"675","Croatia","Europe","c",2019,"F",1,2,12,14,10,0,"N/A",36,13,12,11,13,49,85
"676","Cuba","Americas","c",2019,"NF",7,6,0,0,1,0,"N/A",1,5,0,2,6,13,14
"677","Cyprus","Europe","c",2019,"F",1,1,12,15,11,0,"N/A",38,15,12,15,14,56,94
"678","Czech Republic","Europe","c",2019,"F",1,1,12,15,9,0,"N/A",36,14,12,14,15,55,91
"679","Denmark","Europe","c",2019,"F",1,1,12,16,12,0,"N/A",40,16,12,14,15,57,97
"680","Djibouti","Africa","c",2019,"NF",6,5,2,3,2,0,"N/A",7,6,3,4,6,19,26
"681","Dominica","Americas","c",2019,"F",1,1,11,16,10,0,"N/A",37,15,11,15,15,56,93
"682","Dominican Republic","Americas","c",2019,"PF",3,3,9,10,7,0,"N/A",26,14,10,8,9,41,67
"683","Ecuador","Americas","c",2019,"PF",3,3,7,11,7,0,"N/A",25,12,9,7,10,38,63
"684","Egypt","Africa","c",2019,"NF",6,6,2,3,3,0,"N/A",8,4,1,3,6,14,22
"685","El Salvador","Americas","c",2019,"F",2,3,11,13,8,0,"N/A",32,12,8,7,8,35,67
"686","Equatorial Guinea","Africa","c",2019,"NF",7,7,0,0,0,0,"N/A",0,3,0,0,3,6,6
"687","Eritrea","Africa","c",2019,"NF",7,7,0,0,1,0,"N/A",1,0,0,0,1,1,2
"688","Estonia","Europe","c",2019,"F",1,1,12,15,11,0,"N/A",38,16,12,14,14,56,94
"689","Ethiopia","Africa","c",2019,"NF",6,6,1,3,3,0,"N/A",7,4,2,2,4,12,19
"690","Fiji","Asia","c",2019,"PF",3,3,8,9,7,0,"N/A",24,12,8,7,10,37,61
"691","Finland","Europe","c",2019,"F",1,1,12,16,12,0,"N/A",40,16,12,16,16,60,100
"692","France","Europe","c",2019,"F",1,2,12,15,11,0,"N/A",38,14,11,13,14,52,90
"693","Gabon","Africa","c",2019,"NF",7,5,0,2,2,0,"N/A",4,8,3,3,5,19,23
"694","Gaza Strip","Middle East","t",2019,"NF",7,6,0,2,1,0,"N/A",3,4,2,0,2,8,11
"695","Georgia","Eurasia","c",2019,"PF",3,3,8,10,7,0,"N/A",25,10,8,8,12,38,63
"696","Germany","Europe","c",2019,"F",1,1,12,15,12,0,"N/A",39,14,12,14,15,55,94
"697","Ghana","Africa","c",2019,"F",1,2,12,14,10,0,"N/A",36,14,11,11,11,47,83
"698","Greece","Europe","c",2019,"F",1,2,12,15,9,0,"N/A",36,14,12,11,14,51,87
"699","Grenada","Americas","c",2019,"F",1,2,11,16,10,0,"N/A",37,15,11,13,13,52,89
"700","Guatemala","Americas","c",2019,"PF",4,4,8,10,4,0,"N/A",22,11,6,6,8,31,53
"701","Guinea","Africa","c",2019,"PF",5,4,6,8,3,0,"N/A",17,11,5,4,6,26,43
"702","Guinea-Bissau","Africa","c",2019,"PF",5,4,6,8,1,0,"N/A",15,11,7,4,5,27,42
"703","Guyana","Americas","c",2019,"F",2,3,11,13,8,0,"N/A",32,15,11,8,9,43,75
"704","Haiti","Americas","c",2019,"PF",5,5,5,7,5,0,"N/A",17,10,4,4,6,24,41
"705","Honduras","Americas","c",2019,"PF",4,4,7,8,5,0,"N/A",20,9,4,5,8,26,46
"706","Hong Kong","Asia","t",2019,"PF",5,2,2,7,6,0,"N/A",15,12,8,11,13,44,59
"707","Hungary","Europe","c",2019,"PF",3,3,9,11,7,0,"N/A",27,10,10,10,13,43,70
"708","Iceland","Europe","c",2019,"F",1,1,12,15,10,0,"N/A",37,15,12,15,15,57,94
"709","India","Asia","c",2019,"F",2,3,12,14,9,0,"N/A",35,11,10,9,10,40,75
"710","Indian Kashmir","Asia","t",2019,"PF",4,4,9,9,4,0,"N/A",22,9,5,5,8,27,49
"711","Indonesia","Asia","c",2019,"PF",2,4,11,13,6,0,"N/A",30,11,7,5,9,32,62
"712","Iran","Middle East","c",2019,"NF",6,6,3,2,2,0,"N/A",7,3,1,3,4,11,18
"713","Iraq","Middle East","c",2019,"NF",5,6,8,8,2,1,"N/A",17,5,5,1,4,15,32
"714","Ireland","Europe","c",2019,"F",1,1,12,16,11,0,"N/A",39,16,12,14,16,58,97
"715","Israel","Middle East","c",2019,"F",2,3,12,13,10,0,"N/A",35,12,9,11,11,43,78
"716","Italy","Europe","c",2019,"F",1,1,12,14,10,0,"N/A",36,15,12,12,14,53,89
"717","Jamaica","Americas","c",2019,"F",2,2,12,13,9,0,"N/A",34,15,10,8,11,44,78
"718","Japan","Asia","c",2019,"F",1,1,12,16,12,0,"N/A",40,15,12,15,14,56,96
"719","Jordan","Middle East","c",2019,"PF",5,5,3,6,3,0,"N/A",12,7,3,7,8,25,37
"720","Kazakhstan","Eurasia","c",2019,"NF",7,5,1,3,1,0,"N/A",5,4,1,4,8,17,22
"721","Kenya","Africa","c",2019,"PF",4,4,6,8,5,0,"N/A",19,10,7,5,7,29,48
"722","Kiribati","Asia","c",2019,"F",1,1,12,15,10,0,"N/A",37,16,12,15,13,56,93
"723","Kosovo","Europe","c",2019,"PF",3,4,9,10,5,0,"N/A",24,9,8,6,7,30,54
"724","Kuwait","Middle East","c",2019,"PF",5,5,2,7,4,0,"N/A",13,6,4,7,6,23,36
"725","Kyrgyzstan","Eurasia","c",2019,"PF",5,4,4,5,4,1,"N/A",12,10,5,4,7,26,38
"726","Laos","Asia","c",2019,"NF",7,6,0,0,2,0,"N/A",2,4,0,2,6,12,14
"727","Latvia","Europe","c",2019,"F",2,2,12,14,9,0,"N/A",35,14,12,12,14,52,87
"728","Lebanon","Middle East","c",2019,"PF",5,4,5,7,2,0,"N/A",14,11,8,5,7,31,45
"729","Lesotho","Africa","c",2019,"PF",3,3,10,11,6,0,"N/A",27,12,7,8,9,36,63
"730","Liberia","Africa","c",2019,"PF",3,3,8,12,7,0,"N/A",27,11,8,7,9,35,62
"731","Libya","Africa","c",2019,"NF",7,6,0,1,0,0,"N/A",1,4,2,0,2,8,9
"732","Liechtenstein","Europe","c",2019,"F",2,1,10,13,10,0,"N/A",33,16,12,14,15,57,90
"733","Lithuania","Europe","c",2019,"F",1,1,12,16,10,0,"N/A",38,16,11,12,14,53,91
"734","Luxembourg","Europe","c",2019,"F",1,1,12,16,10,0,"N/A",38,16,12,16,16,60,98
"735","Macedonia","Europe","c",2019,"PF",4,3,6,10,6,0,"N/A",22,11,8,8,10,37,59
"736","Madagascar","Africa","c",2019,"PF",3,4,9,10,5,0,"N/A",24,10,8,7,7,32,56
"737","Malawi","Africa","c",2019,"PF",3,3,8,12,6,0,"N/A",26,14,8,9,7,38,64
"738","Malaysia","Asia","c",2019,"PF",4,4,6,9,6,0,"N/A",21,9,6,7,9,31,52
"739","Maldives","Asia","c",2019,"PF",5,5,5,6,3,0,"N/A",14,3,6,5,7,21,35
"740","Mali","Africa","c",2019,"PF",4,4,6,8,4,0,"N/A",18,10,6,6,4,26,44
"741","Malta","Europe","c",2019,"F",2,1,12,14,9,0,"N/A",35,15,12,15,14,56,91
"742","Marshall Islands","Asia","c",2019,"F",1,1,12,16,10,0,"N/A",38,16,11,15,13,55,93
"743","Mauritania","Africa","c",2019,"NF",6,5,5,2,4,0,"N/A",11,9,4,4,4,21,32
"744","Mauritius","Africa","c",2019,"F",1,2,12,15,10,0,"N/A",37,15,12,13,12,52,89
"745","Mexico","Americas","c",2019,"PF",3,3,9,13,5,0,"N/A",27,13,7,6,10,36,63
"746","Micronesia","Asia","c",2019,"F",1,1,12,15,10,0,"N/A",37,16,11,15,13,55,92
"747","Moldova","Eurasia","c",2019,"PF",3,4,9,11,4,0,"N/A",24,11,8,6,9,34,58
"748","Monaco","Europe","c",2019,"F",3,1,8,10,8,0,"N/A",26,16,12,14,14,56,82
"749","Mongolia","Asia","c",2019,"F",1,2,11,16,9,0,"N/A",36,14,11,12,12,49,85
"750","Montenegro","Europe","c",2019,"PF",4,3,8,9,6,0,"N/A",23,11,9,10,12,42,65
"751","Morocco","Africa","c",2019,"PF",5,5,5,6,3,0,"N/A",14,7,5,6,7,25,39
"752","Mozambique","Africa","c",2019,"PF",4,4,5,9,5,0,"N/A",19,9,7,7,9,32,51
"753","Myanmar","Asia","c",2019,"PF",5,5,5,8,4,4,"N/A",13,5,6,1,5,17,30
"754","Nagorno-Karabakh","Eurasia","t",2019,"PF",5,5,4,5,3,0,"N/A",12,6,4,4,5,19,31
"755","Namibia","Africa","c",2019,"F",3,2,10,11,8,0,"N/A",29,14,11,11,10,46,75
"756","Nauru","Asia","c",2019,"F",2,2,12,14,8,0,"N/A",34,13,9,10,12,44,78
"757","Nepal","Asia","c",2019,"PF",3,4,10,10,5,0,"N/A",25,9,6,6,8,29,54
"758","Netherlands","Europe","c",2019,"F",1,1,12,16,12,0,"N/A",40,16,12,15,16,59,99
"759","New Zealand","Asia","c",2019,"F",1,1,12,16,12,0,"N/A",40,16,12,15,15,58,98
"760","Nicaragua","Americas","c",2019,"NF",6,5,3,4,3,0,"N/A",10,8,2,4,8,22,32
"761","Niger","Africa","c",2019,"PF",4,4,6,8,6,0,"N/A",20,11,6,6,6,29,49
"762","Nigeria","Africa","c",2019,"PF",3,5,9,10,6,0,"N/A",25,9,7,4,5,25,50
"763","North Korea","Asia","c",2019,"NF",7,7,0,0,0,0,"N/A",0,0,0,0,3,3,3
"764","Northern Cyprus","Europe","t",2019,"F",2,2,11,13,7,0,"N/A",31,15,11,13,11,50,81
"765","Norway","Europe","c",2019,"F",1,1,12,16,12,0,"N/A",40,16,12,16,16,60,100
"766","Oman","Middle East","c",2019,"NF",6,5,2,2,2,0,"N/A",6,5,3,4,5,17,23
"767","Pakistan","Asia","c",2019,"PF",5,5,5,7,5,0,"N/A",17,6,6,4,6,22,39
"768","Pakistani Kashmir","Asia","t",2019,"NF",6,5,4,4,3,2,"N/A",9,6,4,3,6,19,28
"769","Palau","Asia","c",2019,"F",1,1,12,15,10,0,"N/A",37,16,11,15,13,55,92
"770","Panama","Americas","c",2019,"F",1,2,12,15,9,0,"N/A",36,15,11,10,12,48,84
"771","Papua New Guinea","Asia","c",2019,"PF",4,3,7,13,3,0,"N/A",23,14,10,8,9,41,64
"772","Paraguay","Americas","c",2019,"PF",3,3,10,12,6,0,"N/A",28,12,8,7,10,37,65
"773","Peru","Americas","c",2019,"F",2,3,11,13,7,0,"N/A",31,15,8,8,11,42,73
"774","Philippines","Asia","c",2019,"PF",3,3,9,10,7,0,"N/A",26,14,8,3,10,35,61
"775","Poland","Europe","c",2019,"F",2,2,11,16,8,0,"N/A",35,14,10,11,14,49,84
"776","Portugal","Europe","c",2019,"F",1,1,12,16,11,0,"N/A",39,16,12,14,15,57,96
"777","Qatar","Middle East","c",2019,"NF",6,5,2,2,3,0,"N/A",7,7,2,5,4,18,25
"778","Romania","Europe","c",2019,"F",2,2,11,14,9,0,"N/A",34,13,10,12,12,47,81
"779","Russia","Eurasia","c",2019,"NF",7,6,0,3,2,0,"N/A",5,3,3,2,7,15,20
"780","Rwanda","Africa","c",2019,"NF",6,6,2,2,5,0,"N/A",9,3,2,2,7,14,23
"781","Samoa","Asia","c",2019,"F",2,2,9,12,9,0,"N/A",30,14,11,14,12,51,81
"782","San Marino","Europe","c",2019,"F",1,1,12,15,11,0,"N/A",38,15,12,15,15,57,95
"783","Sao Tome and Principe","Africa","c",2019,"F",2,2,11,14,9,0,"N/A",34,15,11,12,11,49,83
"784","Saudi Arabia","Middle East","c",2019,"NF",7,7,0,0,1,0,"N/A",1,2,0,2,2,6,7
"785","Senegal","Africa","c",2019,"F",2,3,10,12,8,0,"N/A",30,13,9,9,11,42,72
"786","Serbia","Europe","c",2019,"PF",3,3,8,10,6,0,"N/A",24,12,10,9,12,43,67
"787","Seychelles","Africa","c",2019,"PF",3,3,10,11,7,0,"N/A",28,12,9,11,11,43,71
"788","Sierra Leone","Africa","c",2019,"PF",3,3,10,11,7,0,"N/A",28,12,6,9,10,37,65
"789","Singapore","Asia","c",2019,"PF",4,4,4,8,7,0,"N/A",19,9,4,7,12,32,51
"790","Slovakia","Europe","c",2019,"F",1,2,12,15,9,0,"N/A",36,14,12,12,14,52,88
"791","Slovenia","Europe","c",2019,"F",1,1,12,16,11,0,"N/A",39,14,12,15,14,55,94
"792","Solomon Islands","Asia","c",2019,"F",2,2,9,14,7,0,"N/A",30,16,10,11,12,49,79
"793","Somalia","Africa","c",2019,"NF",7,7,0,1,0,0,"N/A",1,3,3,0,0,6,7
"794","Somaliland","Africa","t",2019,"PF",4,5,5,10,4,0,"N/A",19,6,5,7,6,24,43
"795","South Africa","Africa","c",2019,"F",2,2,12,13,8,0,"N/A",33,15,12,9,10,46,79
"796","South Korea","Asia","c",2019,"F",2,2,11,13,9,0,"N/A",33,14,11,12,13,50,83
"797","South Ossetia","Eurasia","t",2019,"NF",7,6,2,2,0,2,"N/A",2,3,1,1,3,8,10
"798","South Sudan","Africa","c",2019,"NF",7,7,1,1,0,4,"N/A",-2,2,2,0,0,4,2
"799","Spain","Europe","c",2019,"F",1,1,12,16,11,0,"N/A",39,14,11,15,15,55,94
"800","Sri Lanka","Asia","c",2019,"PF",3,4,9,10,6,1,"N/A",24,8,8,8,8,32,56
"801","St. Kitts and Nevis","Americas","c",2019,"F",1,1,10,16,10,0,"N/A",36,15,12,13,13,53,89
"802","St. Lucia","Americas","c",2019,"F",1,1,11,16,11,0,"N/A",38,15,12,13,14,54,92
"803","St. Vincent and the Grenadines","Americas","c",2019,"F",1,1,11,15,10,0,"N/A",36,15,12,14,14,55,91
"804","Sudan","Africa","c",2019,"NF",7,7,2,3,1,3,"N/A",3,2,1,0,1,4,7
"805","Suriname","Americas","c",2019,"F",2,3,12,14,8,0,"N/A",34,14,11,8,10,43,77
"806","Swaziland","Africa","c",2019,"NF",7,6,0,1,0,0,"N/A",1,5,2,4,4,15,16
"807","Sweden","Europe","c",2019,"F",1,1,12,16,12,0,"N/A",40,16,12,16,16,60,100
"808","Switzerland","Europe","c",2019,"F",1,1,12,15,12,0,"N/A",39,15,12,15,15,57,96
"809","Syria","Middle East","c",2019,"NF",7,7,0,0,0,3,"N/A",-3,3,0,0,0,3,0
"810","Taiwan","Asia","c",2019,"F",1,1,12,15,10,0,"N/A",37,16,11,15,14,56,93
"811","Tajikistan","Eurasia","c",2019,"NF",7,6,0,0,0,0,"N/A",0,2,2,1,4,9,9
"812","Tanzania","Africa","c",2019,"PF",4,5,7,7,6,0,"N/A",20,7,5,6,7,25,45
"813","Thailand","Asia","c",2019,"NF",7,5,0,3,2,0,"N/A",5,6,4,5,10,25,30
"814","The Gambia","Africa","c",2019,"PF",4,5,7,9,4,0,"N/A",20,8,6,5,6,25,45
"815","Tibet","Asia","t",2019,"NF",7,7,0,0,1,3,"N/A",-2,0,0,0,3,3,1
"816","Timor-Leste","Asia","c",2019,"F",2,3,11,14,7,0,"N/A",32,14,8,7,9,38,70
"817","Togo","Africa","c",2019,"PF",5,4,4,6,5,0,"N/A",15,9,6,6,7,28,43
"818","Tonga","Asia","c",2019,"F",2,2,9,14,7,0,"N/A",30,14,10,12,13,49,79
"819","Transnistria","Eurasia","t",2019,"NF",6,6,3,5,2,0,"N/A",10,5,2,2,5,14,24
"820","Trinidad and Tobago","Americas","c",2019,"F",2,2,11,13,9,0,"N/A",33,16,11,9,13,49,82
"821","Tunisia","Africa","c",2019,"F",2,3,11,14,6,0,"N/A",31,12,7,9,10,38,69
"822","Turkey","Europe","c",2019,"NF",5,6,5,7,3,0,"N/A",15,5,3,3,5,16,31
"823","Turkmenistan","Eurasia","c",2019,"NF",7,7,0,0,0,0,"N/A",0,0,0,0,2,2,2
"824","Tuvalu","Asia","c",2019,"F",1,1,12,15,10,0,"N/A",37,16,12,15,13,56,93
"825","Uganda","Africa","c",2019,"NF",6,5,3,5,3,0,"N/A",11,10,4,4,7,25,36
"826","Ukraine","Eurasia","c",2019,"PF",3,4,9,11,6,0,"N/A",26,11,7,6,10,34,60
"827","United Arab Emirates","Middle East","c",2019,"NF",7,6,1,2,2,0,"N/A",5,3,2,3,4,12,17
"828","United Kingdom","Europe","c",2019,"F",1,1,12,16,11,0,"N/A",39,14,12,14,14,54,93
"829","United States","Americas","c",2019,"F",2,1,10,14,9,0,"N/A",33,16,11,11,15,53,86
"830","Uruguay","Americas","c",2019,"F",1,1,12,16,12,0,"N/A",40,16,12,15,15,58,98
"831","Uzbekistan","Eurasia","c",2019,"NF",7,6,0,0,1,0,"N/A",1,2,1,1,4,8,9
"832","Vanuatu","Asia","c",2019,"F",2,2,10,15,8,0,"N/A",33,15,11,12,11,49,82
"833","Venezuela","Americas","c",2019,"NF",7,6,0,3,0,0,"N/A",3,7,2,1,6,16,19
"834","Vietnam","Asia","c",2019,"NF",7,5,0,1,2,0,"N/A",3,4,1,4,8,17,20
"835","West Bank","Middle East","t",2019,"NF",7,5,1,4,2,3,"N/A",4,7,5,4,5,21,25
"836","Western Sahara","Africa","t",2019,"NF",7,7,0,0,0,3,"N/A",-3,3,0,0,4,7,4
"837","Yemen","Middle East","c",2019,"NF",7,6,0,1,0,0,"N/A",1,3,3,2,2,10,11
"838","Zambia","Africa","c",2019,"PF",4,4,6,10,6,0,"N/A",22,9,7,8,8,32,54
"839","Zimbabwe","Africa","c",2019,"PF",5,5,3,6,3,0,"N/A",12,8,4,2,5,19,31
"840","Abkhazia","Eurasia","t",2018,"PF",4,5,6,8,4,0,"N/A",18,8,6,4,5,23,41
"841","Afghanistan","Asia","c",2018,"NF",5,6,2,7,3,0,"N/A",12,6,4,2,2,14,26
"842","Albania","Europe","c",2018,"PF",3,3,8,13,7,0,"N/A",28,13,9,9,9,40,68
"843","Algeria","Africa","c",2018,"NF",6,5,3,4,3,0,"N/A",10,7,5,6,7,25,35
"844","Andorra","Europe","c",2018,"F",1,1,12,15,12,0,"N/A",39,15,11,15,16,57,96
"845","Angola","Africa","c",2018,"NF",6,6,3,6,1,0,"N/A",10,7,3,3,3,16,26
"846","Antigua and Barbuda","Americas","c",2018,"F",2,2,12,13,8,0,"N/A",33,15,9,13,13,50,83
"847","Argentina","Americas","c",2018,"F",2,2,11,14,8,0,"N/A",33,15,11,10,14,50,83
"848","Armenia","Eurasia","c",2018,"PF",5,4,4,7,4,0,"N/A",15,9,6,6,9,30,45
"849","Australia","Asia","c",2018,"F",1,1,12,16,12,0,"N/A",40,16,12,15,15,58,98
"850","Austria","Europe","c",2018,"F",1,1,12,15,10,0,"N/A",37,15,12,15,15,57,94
"851","Azerbaijan","Eurasia","c",2018,"NF",7,6,1,2,0,0,"N/A",3,2,1,1,5,9,12
"852","Bahamas","Americas","c",2018,"F",1,1,12,16,10,0,"N/A",38,15,12,13,13,53,91
"853","Bahrain","Middle East","c",2018,"NF",7,6,2,0,3,3,"N/A",2,2,1,1,6,10,12
"854","Bangladesh","Asia","c",2018,"PF",4,4,7,7,5,0,"N/A",19,7,5,5,9,26,45
"855","Barbados","Americas","c",2018,"F",1,1,12,16,10,0,"N/A",38,16,12,15,15,58,96
"856","Belarus","Eurasia","c",2018,"NF",6,6,0,4,2,0,"N/A",6,3,3,2,7,15,21
"857","Belgium","Europe","c",2018,"F",1,1,12,16,11,0,"N/A",39,15,12,14,15,56,95
"858","Belize","Americas","c",2018,"F",1,2,12,14,10,0,"N/A",36,15,10,12,13,50,86
"859","Benin","Africa","c",2018,"F",2,2,9,16,8,0,"N/A",33,15,12,12,10,49,82
"860","Bhutan","Asia","c",2018,"PF",3,4,10,10,9,1,"N/A",28,9,4,6,8,27,55
"861","Bolivia","Americas","c",2018,"PF",3,3,10,11,7,0,"N/A",28,14,9,6,10,39,67
"862","Bosnia and Herzegovina","Europe","c",2018,"PF",4,4,7,10,4,0,"N/A",21,10,7,7,10,34,55
"863","Botswana","Africa","c",2018,"F",3,2,10,10,8,0,"N/A",28,12,10,11,11,44,72
"864","Brazil","Americas","c",2018,"F",2,2,11,14,6,0,"N/A",31,15,10,9,13,47,78
"865","Brunei","Asia","c",2018,"NF",6,5,0,3,3,0,"N/A",6,6,3,6,7,22,28
"866","Bulgaria","Europe","c",2018,"F",2,2,11,14,8,0,"N/A",33,14,11,10,12,47,80
"867","Burkina Faso","Africa","c",2018,"PF",4,3,7,10,6,0,"N/A",23,13,9,7,8,37,60
"868","Burundi","Africa","c",2018,"NF",7,6,1,3,0,0,"N/A",4,6,2,1,5,14,18
"869","Cambodia","Asia","c",2018,"NF",6,5,4,3,3,0,"N/A",10,8,3,3,6,20,30
"870","Cameroon","Africa","c",2018,"NF",6,6,3,3,3,0,"N/A",9,6,2,1,4,13,22
"871","Canada","Americas","c",2018,"F",1,1,12,16,12,0,"N/A",40,16,12,15,16,59,99
"872","Cape Verde","Africa","c",2018,"F",1,1,12,15,10,0,"N/A",37,15,11,14,13,53,90
"873","Central African Republic","Africa","c",2018,"NF",7,7,3,2,0,1,"N/A",4,4,1,0,0,5,9
"874","Chad","Africa","c",2018,"NF",7,6,2,1,1,0,"N/A",4,6,4,1,3,14,18
"875","Chile","Americas","c",2018,"F",1,1,12,15,10,0,"N/A",37,16,12,14,15,57,94
"876","China","Asia","c",2018,"NF",7,6,0,0,2,2,"N/A",0,3,3,2,6,14,14
"877","Colombia","Americas","c",2018,"PF",3,3,10,11,8,0,"N/A",29,12,5,9,10,36,65
"878","Comoros","Africa","c",2018,"PF",3,4,9,11,4,0,"N/A",24,10,7,8,6,31,55
"879","Congo (Brazzaville)","Africa","c",2018,"NF",7,5,0,2,0,0,"N/A",2,7,5,1,6,19,21
"880","Congo (Kinshasa)","Africa","c",2018,"NF",7,6,0,3,1,0,"N/A",4,7,2,0,4,13,17
"881","Costa Rica","Americas","c",2018,"F",1,1,12,15,11,0,"N/A",38,16,11,13,13,53,91
"882","Cote d'Ivoire","Africa","c",2018,"PF",4,4,7,8,4,0,"N/A",19,11,8,6,7,32,51
"883","Crimea","Eurasia","t",2018,"NF",7,6,0,0,0,1,"N/A",-1,3,1,0,6,10,9
"884","Croatia","Europe","c",2018,"F",1,2,12,15,10,0,"N/A",37,13,12,11,13,49,86
"885","Cuba","Americas","c",2018,"NF",7,6,0,0,1,0,"N/A",1,5,0,2,6,13,14
"886","Cyprus","Europe","c",2018,"F",1,1,11,16,11,0,"N/A",38,15,12,15,14,56,94
"887","Czech Republic","Europe","c",2018,"F",1,1,12,15,10,0,"N/A",37,15,12,14,15,56,93
"888","Denmark","Europe","c",2018,"F",1,1,12,16,12,0,"N/A",40,16,12,14,15,57,97
"889","Djibouti","Africa","c",2018,"NF",6,5,2,3,2,0,"N/A",7,6,3,4,6,19,26
"890","Dominica","Americas","c",2018,"F",1,1,11,16,10,0,"N/A",37,15,11,15,15,56,93
"891","Dominican Republic","Americas","c",2018,"PF",3,3,9,10,7,0,"N/A",26,14,10,8,9,41,67
"892","Ecuador","Americas","c",2018,"PF",3,3,7,11,7,0,"N/A",25,12,7,6,10,35,60
"893","Egypt","Africa","c",2018,"NF",6,6,3,4,3,0,"N/A",10,5,2,3,6,16,26
"894","El Salvador","Americas","c",2018,"F",2,3,11,14,9,0,"N/A",34,12,8,8,8,36,70
"895","Equatorial Guinea","Africa","c",2018,"NF",7,7,0,1,0,0,"N/A",1,3,0,0,3,6,7
"896","Eritrea","Africa","c",2018,"NF",7,7,0,0,1,0,"N/A",1,0,0,0,2,2,3
"897","Estonia","Europe","c",2018,"F",1,1,12,15,11,0,"N/A",38,16,12,14,14,56,94
"898","Ethiopia","Africa","c",2018,"NF",7,6,1,0,3,0,"N/A",4,2,0,2,4,8,12
"899","Fiji","Asia","c",2018,"PF",3,3,8,9,7,0,"N/A",24,12,6,7,10,35,59
"900","Finland","Europe","c",2018,"F",1,1,12,16,12,0,"N/A",40,16,12,16,16,60,100
"901","France","Europe","c",2018,"F",1,2,12,15,11,0,"N/A",38,14,11,13,14,52,90
"902","Gabon","Africa","c",2018,"NF",7,5,0,2,2,0,"N/A",4,8,3,3,5,19,23
"903","Gaza Strip","Middle East","t",2018,"NF",7,6,0,2,1,0,"N/A",3,4,3,0,2,9,12
"904","Georgia","Eurasia","c",2018,"PF",3,3,9,10,7,0,"N/A",26,11,8,8,11,38,64
"905","Germany","Europe","c",2018,"F",1,1,12,15,12,0,"N/A",39,14,12,14,15,55,94
"906","Ghana","Africa","c",2018,"F",1,2,12,15,10,0,"N/A",37,14,11,11,10,46,83
"907","Greece","Europe","c",2018,"F",2,2,12,15,8,0,"N/A",35,14,12,11,13,50,85
"908","Grenada","Americas","c",2018,"F",1,2,11,16,10,0,"N/A",37,15,11,12,13,51,88
"909","Guatemala","Americas","c",2018,"PF",4,4,8,10,5,0,"N/A",23,12,6,7,8,33,56
"910","Guinea","Africa","c",2018,"PF",5,5,6,8,3,0,"N/A",17,10,5,4,5,24,41
"911","Guinea-Bissau","Africa","c",2018,"PF",5,5,7,8,1,0,"N/A",16,10,6,4,5,25,41
"912","Guyana","Americas","c",2018,"F",2,3,11,13,8,0,"N/A",32,15,10,8,9,42,74
"913","Haiti","Americas","c",2018,"PF",5,5,5,7,5,0,"N/A",17,10,4,4,6,24,41
"914","Honduras","Americas","c",2018,"PF",4,4,7,8,5,0,"N/A",20,9,4,5,8,26,46
"915","Hong Kong","Asia","t",2018,"PF",5,2,2,7,6,0,"N/A",15,12,8,11,13,44,59
"916","Hungary","Europe","c",2018,"F",3,2,9,12,7,0,"N/A",28,11,10,10,13,44,72
"917","Iceland","Europe","c",2018,"F",1,1,12,15,10,0,"N/A",37,15,12,15,16,58,95
"918","India","Asia","c",2018,"F",2,3,12,14,9,0,"N/A",35,13,10,9,10,42,77
"919","Indian Kashmir","Asia","t",2018,"PF",4,4,9,9,4,0,"N/A",22,9,5,5,8,27,49
"920","Indonesia","Asia","c",2018,"PF",2,4,11,13,6,0,"N/A",30,12,8,5,9,34,64
"921","Iran","Middle East","c",2018,"NF",6,6,3,2,2,0,"N/A",7,3,1,3,4,11,18
"922","Iraq","Middle East","c",2018,"NF",5,6,8,7,2,1,"N/A",16,5,6,0,4,15,31
"923","Ireland","Europe","c",2018,"F",1,1,12,16,11,0,"N/A",39,16,12,14,15,57,96
"924","Israel","Middle East","c",2018,"F",1,3,12,14,10,0,"N/A",36,12,9,11,11,43,79
"925","Italy","Europe","c",2018,"F",1,1,12,14,10,0,"N/A",36,15,12,12,14,53,89
"926","Jamaica","Americas","c",2018,"F",2,3,12,13,9,0,"N/A",34,15,9,8,11,43,77
"927","Japan","Asia","c",2018,"F",1,1,12,16,12,0,"N/A",40,15,12,15,14,56,96
"928","Jordan","Middle East","c",2018,"PF",5,5,3,6,3,0,"N/A",12,7,3,7,8,25,37
"929","Kazakhstan","Eurasia","c",2018,"NF",7,5,1,3,1,0,"N/A",5,4,1,4,8,17,22
"930","Kenya","Africa","c",2018,"PF",4,4,6,8,5,0,"N/A",19,10,7,5,7,29,48
"931","Kiribati","Asia","c",2018,"F",1,1,12,16,10,0,"N/A",38,15,12,15,13,55,93
"932","Kosovo","Europe","c",2018,"PF",3,4,9,10,5,0,"N/A",24,9,6,6,7,28,52
"933","Kuwait","Middle East","c",2018,"PF",5,5,2,7,4,0,"N/A",13,6,4,7,6,23,36
"934","Kyrgyzstan","Eurasia","c",2018,"PF",5,5,4,5,4,1,"N/A",12,10,4,4,7,25,37
"935","Laos","Asia","c",2018,"NF",7,6,0,0,1,0,"N/A",1,4,0,2,5,11,12
"936","Latvia","Europe","c",2018,"F",2,2,12,14,9,0,"N/A",35,15,12,12,13,52,87
"937","Lebanon","Middle East","c",2018,"PF",6,4,3,7,1,0,"N/A",11,12,8,5,7,32,43
"938","Lesotho","Africa","c",2018,"PF",3,3,10,11,6,0,"N/A",27,12,7,9,9,37,64
"939","Liberia","Africa","c",2018,"PF",3,3,8,12,7,0,"N/A",27,11,8,7,9,35,62
"940","Libya","Africa","c",2018,"NF",7,6,0,1,0,0,"N/A",1,4,2,0,2,8,9
"941","Liechtenstein","Europe","c",2018,"F",2,1,10,13,10,0,"N/A",33,16,12,14,15,57,90
"942","Lithuania","Europe","c",2018,"F",1,1,12,16,10,0,"N/A",38,16,11,12,14,53,91
"943","Luxembourg","Europe","c",2018,"F",1,1,12,16,10,0,"N/A",38,16,12,16,16,60,98
"944","Macedonia","Europe","c",2018,"PF",4,3,6,9,6,0,"N/A",21,11,8,8,10,37,58
"945","Madagascar","Africa","c",2018,"PF",3,4,9,10,5,0,"N/A",24,10,8,6,8,32,56
"946","Malawi","Africa","c",2018,"PF",3,3,8,12,6,0,"N/A",26,13,8,9,7,37,63
"947","Malaysia","Asia","c",2018,"PF",4,4,6,7,5,0,"N/A",18,7,6,5,9,27,45
"948","Maldives","Asia","c",2018,"PF",5,5,5,5,4,0,"N/A",14,3,5,6,7,21,35
"949","Mali","Africa","c",2018,"PF",5,4,6,7,4,0,"N/A",17,11,6,6,4,27,44
"950","Malta","Europe","c",2018,"F",1,1,12,14,10,0,"N/A",36,15,12,15,14,56,92
"951","Marshall Islands","Asia","c",2018,"F",1,1,12,15,10,0,"N/A",37,16,11,15,13,55,92
"952","Mauritania","Africa","c",2018,"NF",6,5,3,2,4,0,"N/A",9,9,4,4,4,21,30
"953","Mauritius","Africa","c",2018,"F",1,2,12,15,10,0,"N/A",37,15,12,13,12,52,89
"954","Mexico","Americas","c",2018,"PF",3,3,9,12,5,0,"N/A",26,13,7,6,10,36,62
"955","Micronesia","Asia","c",2018,"F",1,1,12,15,10,0,"N/A",37,16,11,15,14,56,93
"956","Moldova","Eurasia","c",2018,"PF",3,3,10,11,5,0,"N/A",26,12,8,6,9,35,61
"957","Monaco","Europe","c",2018,"F",3,1,7,10,8,0,"N/A",25,16,12,15,14,57,82
"958","Mongolia","Asia","c",2018,"F",1,2,11,16,9,0,"N/A",36,14,11,12,12,49,85
"959","Montenegro","Europe","c",2018,"PF",3,3,8,10,7,0,"N/A",25,11,9,10,12,42,67
"960","Morocco","Africa","c",2018,"PF",5,5,5,6,3,0,"N/A",14,7,5,6,7,25,39
"961","Mozambique","Africa","c",2018,"PF",4,4,6,9,5,0,"N/A",20,9,7,7,9,32,52
"962","Myanmar","Asia","c",2018,"PF",5,5,5,8,4,4,"N/A",13,6,6,1,5,18,31
"963","Nagorno-Karabakh","Eurasia","t",2018,"PF",5,5,4,5,3,0,"N/A",12,6,3,4,5,18,30
"964","Namibia","Africa","c",2018,"F",2,2,10,11,9,0,"N/A",30,14,12,11,10,47,77
"965","Nauru","Asia","c",2018,"F",2,2,12,15,8,0,"N/A",35,13,9,10,14,46,81
"966","Nepal","Asia","c",2018,"PF",3,4,10,10,5,0,"N/A",25,10,6,6,8,30,55
"967","Netherlands","Europe","c",2018,"F",1,1,12,16,12,0,"N/A",40,16,12,15,16,59,99
"968","New Zealand","Asia","c",2018,"F",1,1,12,16,12,0,"N/A",40,16,12,15,15,58,98
"969","Nicaragua","Americas","c",2018,"PF",5,4,3,6,3,0,"N/A",12,11,5,6,10,32,44
"970","Niger","Africa","c",2018,"PF",4,4,6,8,6,0,"N/A",20,11,6,6,6,29,49
"971","Nigeria","Africa","c",2018,"PF",3,5,9,10,6,0,"N/A",25,9,7,4,5,25,50
"972","North Korea","Asia","c",2018,"NF",7,7,0,0,0,0,"N/A",0,0,0,0,3,3,3
"973","Northern Cyprus","Europe","t",2018,"F",2,2,11,13,7,0,"N/A",31,15,11,13,11,50,81
"974","Norway","Europe","c",2018,"F",1,1,12,16,12,0,"N/A",40,16,12,16,16,60,100
"975","Oman","Middle East","c",2018,"NF",6,5,2,2,2,0,"N/A",6,5,3,4,5,17,23
"976","Pakistan","Asia","c",2018,"PF",4,5,6,8,5,0,"N/A",19,7,6,5,6,24,43
"977","Pakistani Kashmir","Asia","t",2018,"NF",6,5,4,4,3,2,"N/A",9,6,4,3,6,19,28
"978","Palau","Asia","c",2018,"F",1,1,12,15,10,0,"N/A",37,16,11,15,13,55,92
"979","Panama","Americas","c",2018,"F",2,2,12,15,8,0,"N/A",35,15,11,10,12,48,83
"980","Papua New Guinea","Asia","c",2018,"PF",3,3,8,13,4,0,"N/A",25,13,9,7,9,38,63
"981","Paraguay","Americas","c",2018,"PF",3,3,10,12,5,0,"N/A",27,12,8,7,10,37,64
"982","Peru","Americas","c",2018,"F",2,3,11,13,7,0,"N/A",31,15,8,8,11,42,73
"983","Philippines","Asia","c",2018,"PF",3,3,9,11,7,0,"N/A",27,14,8,3,10,35,62
"984","Poland","Europe","c",2018,"F",1,2,12,16,8,0,"N/A",36,14,10,11,14,49,85
"985","Portugal","Europe","c",2018,"F",1,1,12,16,11,0,"N/A",39,16,12,15,15,58,97
"986","Qatar","Middle East","c",2018,"NF",6,5,2,2,3,0,"N/A",7,7,2,4,4,17,24
"987","Romania","Europe","c",2018,"F",2,2,11,14,10,0,"N/A",35,14,11,12,12,49,84
"988","Russia","Eurasia","c",2018,"NF",7,6,0,3,2,0,"N/A",5,3,3,2,7,15,20
"989","Rwanda","Africa","c",2018,"NF",6,6,2,1,5,0,"N/A",8,4,2,2,7,15,23
"990","Samoa","Asia","c",2018,"F",2,2,9,12,9,0,"N/A",30,14,10,14,12,50,80
"991","San Marino","Europe","c",2018,"F",1,1,12,15,11,0,"N/A",38,15,12,16,16,59,97
"992","Sao Tome and Principe","Africa","c",2018,"F",2,2,11,14,9,0,"N/A",34,15,10,12,11,48,82
"993","Saudi Arabia","Middle East","c",2018,"NF",7,7,0,0,1,1,"N/A",0,3,0,2,2,7,7
"994","Senegal","Africa","c",2018,"F",2,2,10,13,8,0,"N/A",31,13,10,10,11,44,75
"995","Serbia","Europe","c",2018,"F",3,2,9,12,7,0,"N/A",28,13,10,9,13,45,73
"996","Seychelles","Africa","c",2018,"PF",3,3,10,11,7,0,"N/A",28,12,9,11,11,43,71
"997","Sierra Leone","Africa","c",2018,"PF",3,3,10,11,7,0,"N/A",28,12,7,9,10,38,66
"998","Singapore","Asia","c",2018,"PF",4,4,4,8,7,0,"N/A",19,10,4,7,12,33,52
"999","Slovakia","Europe","c",2018,"F",1,1,12,15,9,0,"N/A",36,15,12,12,14,53,89
"1000","Slovenia","Europe","c",2018,"F",1,1,12,16,11,0,"N/A",39,14,12,14,14,54,93
"1001","Solomon Islands","Asia","c",2018,"F",3,2,9,13,6,0,"N/A",28,14,9,9,12,44,72
"1002","Somalia","Africa","c",2018,"NF",7,7,0,1,0,0,"N/A",1,3,2,0,1,6,7
"1003","Somaliland","Africa","t",2018,"PF",4,5,5,10,4,0,"N/A",19,7,5,7,6,25,44
"1004","South Africa","Africa","c",2018,"F",2,2,12,13,7,0,"N/A",32,15,12,9,10,46,78
"1005","South Korea","Asia","c",2018,"F",2,2,11,13,9,0,"N/A",33,14,11,13,13,51,84
"1006","South Ossetia","Eurasia","t",2018,"NF",7,6,2,2,0,2,"N/A",2,3,1,1,3,8,10
"1007","South Sudan","Africa","c",2018,"NF",7,7,1,1,0,4,"N/A",-2,2,2,0,0,4,2
"1008","Spain","Europe","c",2018,"F",1,1,11,16,11,0,"N/A",38,15,11,15,15,56,94
"1009","Sri Lanka","Asia","c",2018,"PF",3,4,8,10,7,1,"N/A",24,8,8,7,8,31,55
"1010","St. Kitts and Nevis","Americas","c",2018,"F",1,1,10,16,10,0,"N/A",36,15,12,13,13,53,89
"1011","St. Lucia","Americas","c",2018,"F",1,1,11,16,11,0,"N/A",38,15,12,12,14,53,91
"1012","St. Vincent and the Grenadines","Americas","c",2018,"F",1,1,11,15,10,0,"N/A",36,15,12,13,14,54,90
"1013","Sudan","Africa","c",2018,"NF",7,7,2,4,1,3,"N/A",4,2,1,0,1,4,8
"1014","Suriname","Americas","c",2018,"F",2,2,12,14,8,0,"N/A",34,15,11,8,10,44,78
"1015","Swaziland","Africa","c",2018,"NF",7,6,0,1,0,0,"N/A",1,5,2,4,4,15,16
"1016","Sweden","Europe","c",2018,"F",1,1,12,16,12,0,"N/A",40,16,12,16,16,60,100
"1017","Switzerland","Europe","c",2018,"F",1,1,12,15,12,0,"N/A",39,15,12,15,15,57,96
"1018","Syria","Middle East","c",2018,"NF",7,7,0,0,0,3,"N/A",-3,2,0,0,0,2,-1
"1019","Taiwan","Asia","c",2018,"F",1,1,12,15,10,0,"N/A",37,16,11,15,14,56,93
"1020","Tajikistan","Eurasia","c",2018,"NF",7,6,0,0,1,0,"N/A",1,2,2,2,4,10,11
"1021","Tanzania","Africa","c",2018,"PF",4,4,7,9,6,0,"N/A",22,7,6,8,9,30,52
"1022","Thailand","Asia","c",2018,"NF",6,5,0,3,3,0,"N/A",6,6,4,5,10,25,31
"1023","The Gambia","Africa","c",2018,"PF",4,5,7,9,4,0,"N/A",20,7,5,3,6,21,41
"1024","Tibet","Asia","t",2018,"NF",7,7,0,0,1,3,"N/A",-2,0,0,0,3,3,1
"1025","Timor-Leste","Asia","c",2018,"F",2,3,11,14,7,0,"N/A",32,13,8,7,9,37,69
"1026","Togo","Africa","c",2018,"PF",4,4,6,7,5,0,"N/A",18,9,6,7,7,29,47
"1027","Tonga","Asia","c",2018,"F",2,2,9,14,7,0,"N/A",30,12,9,12,12,45,75
"1028","Transnistria","Eurasia","t",2018,"NF",6,6,3,5,2,0,"N/A",10,5,2,2,5,14,24
"1029","Trinidad and Tobago","Americas","c",2018,"F",2,2,11,13,9,0,"N/A",33,15,11,9,13,48,81
"1030","Tunisia","Africa","c",2018,"F",2,3,10,14,6,0,"N/A",30,12,9,9,10,40,70
"1031","Turkey","Europe","c",2018,"NF",5,6,6,7,3,0,"N/A",16,5,3,2,6,16,32
"1032","Turkmenistan","Eurasia","c",2018,"NF",7,7,0,0,0,0,"N/A",0,1,0,0,3,4,4
"1033","Tuvalu","Asia","c",2018,"F",1,1,12,15,10,0,"N/A",37,16,12,15,14,57,94
"1034","Uganda","Africa","c",2018,"PF",6,4,3,5,3,0,"N/A",11,11,4,4,7,26,37
"1035","Ukraine","Eurasia","c",2018,"PF",3,3,9,11,6,0,"N/A",26,11,9,6,10,36,62
"1036","United Arab Emirates","Middle East","c",2018,"NF",7,6,1,2,2,0,"N/A",5,3,2,3,4,12,17
"1037","United Kingdom","Europe","c",2018,"F",1,1,12,16,12,0,"N/A",40,14,12,14,14,54,94
"1038","United States","Americas","c",2018,"F",2,1,10,14,9,0,"N/A",33,16,10,12,15,53,86
"1039","Uruguay","Americas","c",2018,"F",1,1,12,16,12,0,"N/A",40,16,12,15,15,58,98
"1040","Uzbekistan","Eurasia","c",2018,"NF",7,7,0,0,1,0,"N/A",1,1,1,0,4,6,7
"1041","Vanuatu","Asia","c",2018,"F",2,2,10,15,8,0,"N/A",33,15,11,11,11,48,81
"1042","Venezuela","Americas","c",2018,"NF",6,5,2,6,0,0,"N/A",8,8,2,1,7,18,26
"1043","Vietnam","Asia","c",2018,"NF",7,5,0,1,2,0,"N/A",3,4,1,4,8,17,20
"1044","West Bank","Middle East","t",2018,"NF",7,5,2,4,2,3,"N/A",5,8,5,5,5,23,28
"1045","Western Sahara","Africa","t",2018,"NF",7,7,0,0,0,3,"N/A",-3,3,0,0,4,7,4
"1046","Yemen","Middle East","c",2018,"NF",7,6,0,1,0,0,"N/A",1,5,3,2,2,12,13
"1047","Zambia","Africa","c",2018,"PF",4,4,6,10,6,0,"N/A",22,10,7,8,8,33,55
"1048","Zimbabwe","Africa","c",2018,"NF",6,5,2,6,2,0,"N/A",10,8,4,3,5,20,30
"1049","Abkhazia","Eurasia","t",2017,"PF",4,5,6,8,4,0,"0",18,8,6,4,5,23,41
"1050","Afghanistan","Asia","c",2017,"NF",6,6,2,6,2,0,"0",10,6,4,2,2,14,24
"1051","Albania","Europe","c",2017,"PF",3,3,8,13,7,0,"0",28,13,9,9,9,40,68
"1052","Algeria","Africa","c",2017,"NF",6,5,4,4,3,0,"0",11,7,5,5,7,24,35
"1053","Andorra","Europe","c",2017,"F",1,1,12,15,12,0,"0",39,15,11,15,15,56,95
"1054","Angola","Africa","c",2017,"NF",6,6,3,6,1,0,"0",10,5,3,3,3,14,24
"1055","Antigua and Barbuda","Americas","c",2017,"F",2,2,12,13,8,0,"0",33,15,9,13,13,50,83
"1056","Argentina","Americas","c",2017,"F",2,2,11,14,8,0,"0",33,14,11,10,14,49,82
"1057","Armenia","Eurasia","c",2017,"PF",5,4,5,7,4,0,"0",16,9,6,5,9,29,45
"1058","Australia","Asia","c",2017,"F",1,1,12,16,12,0,"0",40,16,12,15,15,58,98
"1059","Austria","Europe","c",2017,"F",1,1,12,15,10,0,"0",37,16,12,15,15,58,95
"1060","Azerbaijan","Eurasia","c",2017,"NF",7,6,1,2,1,0,"0",4,2,1,2,5,10,14
"1061","Bahamas","Americas","c",2017,"F",1,1,12,16,10,0,"0",38,15,12,13,13,53,91
"1062","Bahrain","Middle East","c",2017,"NF",7,6,2,0,3,3,"0",2,2,1,1,6,10,12
"1063","Bangladesh","Asia","c",2017,"PF",4,4,7,8,5,0,"0",20,7,6,5,9,27,47
"1064","Barbados","Americas","c",2017,"F",1,1,12,16,12,0,"0",40,16,12,15,15,58,98
"1065","Belarus","Eurasia","c",2017,"NF",7,6,0,4,1,0,"0",5,3,3,2,7,15,20
"1066","Belgium","Europe","c",2017,"F",1,1,12,16,12,0,"0",40,15,12,13,15,55,95
"1067","Belize","Americas","c",2017,"F",1,2,12,14,10,0,"0",36,15,11,12,13,51,87
"1068","Benin","Africa","c",2017,"F",2,2,9,16,8,0,"0",33,15,12,12,10,49,82
"1069","Bhutan","Asia","c",2017,"PF",3,4,10,10,9,1,"0",28,9,4,6,8,27,55
"1070","Bolivia","Americas","c",2017,"PF",3,3,11,11,7,0,"0",29,14,9,6,10,39,68
"1071","Bosnia and Herzegovina","Europe","c",2017,"PF",4,4,7,10,4,0,"0",21,10,7,7,10,34,55
"1072","Botswana","Africa","c",2017,"F",3,2,10,10,8,0,"0",28,12,10,11,11,44,72
"1073","Brazil","Americas","c",2017,"F",2,2,11,14,6,0,"0",31,15,10,10,13,48,79
"1074","Brunei","Asia","c",2017,"NF",6,5,0,3,3,0,"1",7,6,3,6,7,22,29
"1075","Bulgaria","Europe","c",2017,"F",2,2,11,14,8,0,"0",33,14,11,10,12,47,80
"1076","Burkina Faso","Africa","c",2017,"PF",4,3,7,10,6,0,"0",23,14,9,8,9,40,63
"1077","Burundi","Africa","c",2017,"NF",7,6,1,4,0,0,"0",5,6,2,1,5,14,19
"1078","Cambodia","Asia","c",2017,"NF",6,5,4,4,3,0,"0",11,8,3,3,6,20,31
"1079","Cameroon","Africa","c",2017,"NF",6,6,3,3,3,0,"0",9,7,3,1,4,15,24
"1080","Canada","Americas","c",2017,"F",1,1,12,16,12,0,"0",40,16,12,15,16,59,99
"1081","Cape Verde","Africa","c",2017,"F",1,1,12,15,10,0,"0",37,15,11,14,13,53,90
"1082","Central African Republic","Africa","c",2017,"NF",7,7,3,2,0,1,"0",4,4,1,0,1,6,10
"1083","Chad","Africa","c",2017,"NF",7,6,2,1,1,0,"0",4,6,4,1,3,14,18
"1084","Chile","Americas","c",2017,"F",1,1,12,15,10,0,"0",37,16,12,14,15,57,94
"1085","China","Asia","c",2017,"NF",7,6,0,1,2,2,"0",1,3,3,2,6,14,15
"1086","Colombia","Americas","c",2017,"PF",3,3,10,11,8,0,"0",29,12,5,8,10,35,64
"1087","Comoros","Africa","c",2017,"PF",3,4,9,11,4,0,"0",24,10,7,8,6,31,55
"1088","Congo (Brazzaville)","Africa","c",2017,"NF",7,5,1,2,2,0,"0",5,7,6,2,7,22,27
"1089","Congo (Kinshasa)","Africa","c",2017,"NF",7,6,0,3,1,0,"0",4,8,3,0,4,15,19
"1090","Costa Rica","Americas","c",2017,"F",1,1,12,15,11,0,"0",38,16,11,13,13,53,91
"1091","Cote d'Ivoire","Africa","c",2017,"PF",4,4,7,8,5,0,"0",20,11,8,6,7,32,52
"1092","Crimea","Eurasia","t",2017,"NF",7,6,0,0,0,1,"0",-1,3,1,0,6,10,9
"1093","Croatia","Europe","c",2017,"F",1,2,12,15,10,0,"0",37,14,12,11,13,50,87
"1094","Cuba","Americas","c",2017,"NF",7,6,0,0,1,0,"0",1,5,0,3,6,14,15
"1095","Cyprus","Europe","c",2017,"F",1,1,11,16,11,0,"0",38,15,12,15,14,56,94
"1096","Czech Republic","Europe","c",2017,"F",1,1,12,15,11,0,"0",38,15,12,14,15,56,94
"1097","Denmark","Europe","c",2017,"F",1,1,12,16,12,0,"0",40,16,12,14,15,57,97
"1098","Djibouti","Africa","c",2017,"NF",6,5,2,3,2,0,"0",7,6,3,4,6,19,26
"1099","Dominica","Americas","c",2017,"F",1,1,12,16,10,0,"0",38,15,12,15,15,57,95
"1100","Dominican Republic","Americas","c",2017,"PF",3,3,9,10,8,0,"0",27,14,10,8,9,41,68
"1101","Ecuador","Americas","c",2017,"PF",3,4,7,11,6,0,"0",24,11,6,6,10,33,57
"1102","Egypt","Africa","c",2017,"NF",6,5,3,4,2,0,"0",9,5,4,2,6,17,26
"1103","El Salvador","Americas","c",2017,"F",2,3,11,14,9,0,"0",34,12,8,8,8,36,70
"1104","Equatorial Guinea","Africa","c",2017,"NF",7,7,0,1,0,0,"0",1,4,0,0,3,7,8
"1105","Eritrea","Africa","c",2017,"NF",7,7,0,0,1,0,"0",1,0,0,0,2,2,3
"1106","Estonia","Europe","c",2017,"F",1,1,12,15,11,0,"0",38,16,12,14,14,56,94
"1107","Ethiopia","Africa","c",2017,"NF",7,6,1,0,3,0,"0",4,2,0,2,4,8,12
"1108","Fiji","Asia","c",2017,"PF",3,4,8,10,7,0,"0",25,12,5,7,10,34,59
"1109","Finland","Europe","c",2017,"F",1,1,12,16,12,0,"0",40,16,12,16,16,60,100
"1110","France","Europe","c",2017,"F",1,2,12,15,11,0,"0",38,14,11,13,14,52,90
"1111","Gabon","Africa","c",2017,"NF",6,5,2,3,3,0,"0",8,9,4,6,5,24,32
"1112","Gaza Strip","Middle East","t",2017,"NF",7,6,0,2,1,0,"0",3,4,3,0,2,9,12
"1113","Georgia","Eurasia","c",2017,"PF",3,3,9,11,7,0,"0",27,11,8,8,10,37,64
"1114","Germany","Europe","c",2017,"F",1,1,12,15,12,0,"0",39,15,12,14,15,56,95
"1115","Ghana","Africa","c",2017,"F",1,2,12,15,10,0,"0",37,14,11,11,10,46,83
"1116","Greece","Europe","c",2017,"F",2,2,12,15,8,0,"0",35,14,11,11,13,49,84
"1117","Grenada","Americas","c",2017,"F",1,2,12,16,10,0,"0",38,15,11,12,13,51,89
"1118","Guatemala","Americas","c",2017,"PF",4,4,8,10,5,0,"0",23,11,6,6,8,31,54
"1119","Guinea","Africa","c",2017,"PF",5,5,6,8,3,0,"0",17,10,5,4,5,24,41
"1120","Guinea-Bissau","Africa","c",2017,"PF",5,5,7,8,1,0,"0",16,10,5,4,5,24,40
"1121","Guyana","Americas","c",2017,"F",2,3,11,13,8,0,"0",32,15,10,8,9,42,74
"1122","Haiti","Americas","c",2017,"PF",5,5,3,8,4,0,"0",15,10,4,4,6,24,39
"1123","Honduras","Americas","c",2017,"PF",4,4,7,8,4,0,"0",19,9,5,5,8,27,46
"1124","Hong Kong","Asia","t",2017,"PF",5,2,3,7,6,0,"0",16,12,8,12,13,45,61
"1125","Hungary","Europe","c",2017,"F",3,2,9,13,7,0,"0",29,13,11,10,13,47,76
"1126","Iceland","Europe","c",2017,"F",1,1,12,16,10,0,"0",38,16,12,15,16,59,97
"1127","India","Asia","c",2017,"F",2,3,12,14,9,0,"0",35,13,10,9,10,42,77
"1128","Indian Kashmir","Asia","t",2017,"PF",4,4,9,9,4,0,"0",22,9,5,6,8,28,50
"1129","Indonesia","Asia","c",2017,"PF",2,4,11,14,6,0,"0",31,12,8,5,9,34,65
"1130","Iran","Middle East","c",2017,"NF",6,6,3,2,2,0,"0",7,2,1,3,4,10,17
"1131","Iraq","Middle East","c",2017,"NF",5,6,8,5,2,3,"0",12,5,6,0,4,15,27
"1132","Ireland","Europe","c",2017,"F",1,1,12,16,11,0,"0",39,16,12,14,15,57,96
"1133","Israel","Middle East","c",2017,"F",1,2,12,14,10,0,"0",36,12,10,11,11,44,80
"1134","Italy","Europe","c",2017,"F",1,1,12,14,10,0,"0",36,15,12,12,14,53,89
"1135","Jamaica","Americas","c",2017,"F",2,3,12,13,9,0,"0",34,15,9,7,10,41,75
"1136","Japan","Asia","c",2017,"F",1,1,12,16,12,0,"0",40,15,12,15,14,56,96
"1137","Jordan","Middle East","c",2017,"PF",5,5,3,6,3,0,"0",12,7,4,6,8,25,37
"1138","Kazakhstan","Eurasia","c",2017,"NF",7,5,1,3,1,0,"0",5,4,1,4,8,17,22
"1139","Kenya","Africa","c",2017,"PF",4,4,7,10,5,0,"0",22,10,7,5,7,29,51
"1140","Kiribati","Asia","c",2017,"F",1,1,12,16,9,0,"0",37,15,12,15,13,55,92
"1141","Kosovo","Europe","c",2017,"PF",3,4,9,10,5,0,"0",24,9,6,6,7,28,52
"1142","Kuwait","Middle East","c",2017,"PF",5,5,2,7,4,0,"0",13,6,4,7,6,23,36
"1143","Kyrgyzstan","Eurasia","c",2017,"PF",5,5,5,6,4,2,"0",13,9,4,4,7,24,37
"1144","Laos","Asia","c",2017,"NF",7,6,0,0,1,0,"0",1,4,0,2,5,11,12
"1145","Latvia","Europe","c",2017,"F",1,2,12,15,9,0,"0",36,15,12,12,12,51,87
"1146","Lebanon","Middle East","c",2017,"PF",5,4,3,9,2,0,"0",14,11,7,5,7,30,44
"1147","Lesotho","Africa","c",2017,"PF",3,3,10,11,6,0,"0",27,12,7,9,9,37,64
"1148","Liberia","Africa","c",2017,"PF",3,4,9,12,7,0,"0",28,11,8,7,8,34,62
"1149","Libya","Africa","c",2017,"NF",7,6,1,2,0,0,"0",3,4,2,0,4,10,13
"1150","Liechtenstein","Europe","c",2017,"F",2,1,10,13,10,0,"0",33,16,12,14,16,58,91
"1151","Lithuania","Europe","c",2017,"F",1,1,12,16,10,0,"0",38,16,11,13,13,53,91
"1152","Luxembourg","Europe","c",2017,"F",1,1,12,16,10,0,"0",38,16,12,16,16,60,98
"1153","Macedonia","Europe","c",2017,"PF",4,3,6,10,5,0,"0",21,10,8,8,10,36,57
"1154","Madagascar","Africa","c",2017,"PF",3,4,9,10,5,0,"0",24,10,8,6,8,32,56
"1155","Malawi","Africa","c",2017,"PF",3,3,8,12,6,0,"0",26,13,8,9,7,37,63
"1156","Malaysia","Asia","c",2017,"PF",4,4,6,7,5,0,"0",18,7,5,5,9,26,44
"1157","Maldives","Asia","c",2017,"PF",5,5,7,5,5,0,"0",17,5,5,6,7,23,40
"1158","Mali","Africa","c",2017,"PF",5,4,6,7,4,0,"0",17,12,6,6,4,28,45
"1159","Malta","Europe","c",2017,"F",1,1,12,16,11,0,"0",39,16,12,15,14,57,96
"1160","Marshall Islands","Asia","c",2017,"F",1,1,12,15,10,0,"0",37,16,11,15,13,55,92
"1161","Mauritania","Africa","c",2017,"NF",6,5,3,2,4,0,"0",9,9,4,4,4,21,30
"1162","Mauritius","Africa","c",2017,"F",1,2,12,15,10,0,"0",37,15,12,13,12,52,89
"1163","Mexico","Americas","c",2017,"PF",3,3,9,12,7,0,"0",28,13,8,6,10,37,65
"1164","Micronesia","Asia","c",2017,"F",1,1,12,15,10,0,"0",37,16,11,15,14,56,93
"1165","Moldova","Eurasia","c",2017,"PF",3,3,10,12,5,0,"0",27,12,8,6,9,35,62
"1166","Monaco","Europe","c",2017,"F",3,1,7,11,9,0,"0",27,16,12,15,14,57,84
"1167","Mongolia","Asia","c",2017,"F",1,2,11,16,9,0,"0",36,14,11,12,12,49,85
"1168","Montenegro","Europe","c",2017,"PF",3,3,8,11,7,0,"0",26,12,9,10,12,43,69
"1169","Morocco","Africa","c",2017,"PF",5,4,5,7,3,0,"0",15,7,6,6,7,26,41
"1170","Mozambique","Africa","c",2017,"PF",4,4,6,9,5,0,"0",20,11,7,7,8,33,53
"1171","Myanmar","Asia","c",2017,"PF",5,5,5,8,4,3,"0",14,7,5,1,5,18,32
"1172","Nagorno-Karabakh","Eurasia","t",2017,"PF",5,5,6,6,3,0,"0",15,6,3,4,5,18,33
"1173","Namibia","Africa","c",2017,"F",2,2,10,11,9,0,"0",30,14,12,11,10,47,77
"1174","Nauru","Asia","c",2017,"F",2,2,12,15,8,0,"0",35,13,9,10,14,46,81
"1175","Nepal","Asia","c",2017,"PF",3,4,9,10,5,0,"0",24,9,5,6,8,28,52
"1176","Netherlands","Europe","c",2017,"F",1,1,12,16,12,0,"0",40,16,12,15,16,59,99
"1177","New Zealand","Asia","c",2017,"F",1,1,12,16,12,0,"0",40,16,12,15,15,58,98
"1178","Nicaragua","Americas","c",2017,"PF",5,4,3,6,5,0,"0",14,11,5,7,10,33,47
"1179","Niger","Africa","c",2017,"PF",4,4,6,9,6,0,"0",21,11,6,5,6,28,49
"1180","Nigeria","Africa","c",2017,"PF",3,5,9,10,6,0,"0",25,9,7,4,5,25,50
"1181","North Korea","Asia","c",2017,"NF",7,7,0,0,0,0,"0",0,0,0,0,3,3,3
"1182","Northern Cyprus","Europe","t",2017,"F",2,2,11,12,9,0,"0",32,14,11,12,11,48,80
"1183","Norway","Europe","c",2017,"F",1,1,12,16,12,0,"0",40,16,12,16,16,60,100
"1184","Oman","Middle East","c",2017,"NF",6,5,2,2,2,0,"2",8,5,3,4,5,17,25
"1185","Pakistan","Asia","c",2017,"PF",4,5,7,8,6,0,"0",21,6,6,4,6,22,43
"1186","Pakistani Kashmir","Asia","t",2017,"NF",6,5,4,4,3,2,"0",9,6,4,3,6,19,28
"1187","Palau","Asia","c",2017,"F",1,1,12,15,10,0,"0",37,16,11,15,13,55,92
"1188","Panama","Americas","c",2017,"F",2,2,12,15,8,0,"0",35,15,11,10,12,48,83
"1189","Papua New Guinea","Asia","c",2017,"PF",3,3,9,13,4,0,"0",26,13,9,7,9,38,64
"1190","Paraguay","Americas","c",2017,"PF",3,3,10,12,5,0,"0",27,12,8,7,10,37,64
"1191","Peru","Americas","c",2017,"F",2,3,11,13,7,0,"0",31,15,8,8,10,41,72
"1192","Philippines","Asia","c",2017,"PF",3,3,9,11,7,0,"0",27,14,8,4,10,36,63
"1193","Poland","Europe","c",2017,"F",1,2,12,16,9,0,"0",37,14,12,12,14,52,89
"1194","Portugal","Europe","c",2017,"F",1,1,12,16,11,0,"0",39,16,12,15,15,58,97
"1195","Qatar","Middle East","c",2017,"NF",6,5,2,2,3,0,"2",9,7,2,4,4,17,26
"1196","Romania","Europe","c",2017,"F",2,2,11,14,10,0,"0",35,14,11,12,12,49,84
"1197","Russia","Eurasia","c",2017,"NF",7,6,0,3,2,0,"0",5,3,3,2,7,15,20
"1198","Rwanda","Africa","c",2017,"NF",6,6,2,1,5,0,"0",8,4,2,3,7,16,24
"1199","Samoa","Asia","c",2017,"F",2,2,9,12,9,0,"0",30,14,10,14,12,50,80
"1200","San Marino","Europe","c",2017,"F",1,1,12,15,11,0,"0",38,15,12,16,16,59,97
"1201","Sao Tome and Principe","Africa","c",2017,"F",2,2,11,14,9,0,"0",34,15,10,12,10,47,81
"1202","Saudi Arabia","Middle East","c",2017,"NF",7,7,0,0,1,0,"2",3,3,0,2,2,7,10
"1203","Senegal","Africa","c",2017,"F",2,2,11,13,8,0,"0",32,15,10,10,11,46,78
"1204","Serbia","Europe","c",2017,"F",3,2,9,13,7,0,"0",29,14,10,10,13,47,76
"1205","Seychelles","Africa","c",2017,"PF",3,3,10,11,7,0,"0",28,12,9,11,11,43,71
"1206","Sierra Leone","Africa","c",2017,"PF",3,3,10,11,7,0,"0",28,12,7,9,10,38,66
"1207","Singapore","Asia","c",2017,"PF",4,4,4,8,7,0,"0",19,9,4,7,12,32,51
"1208","Slovakia","Europe","c",2017,"F",1,1,12,15,9,0,"0",36,15,12,12,14,53,89
"1209","Slovenia","Europe","c",2017,"F",1,1,12,16,11,0,"0",39,14,12,14,13,53,92
"1210","Solomon Islands","Asia","c",2017,"F",3,2,9,13,5,0,"0",27,14,9,9,12,44,71
"1211","Somalia","Africa","c",2017,"NF",7,7,0,0,0,0,"0",0,3,1,0,1,5,5
"1212","Somaliland","Africa","t",2017,"PF",5,5,2,9,4,0,"0",15,7,5,7,6,25,40
"1213","South Africa","Africa","c",2017,"F",2,2,12,14,7,0,"0",33,15,11,9,10,45,78
"1214","South Korea","Asia","c",2017,"F",2,2,11,13,8,0,"0",32,13,11,13,13,50,82
"1215","South Ossetia","Eurasia","t",2017,"NF",7,6,2,2,0,2,"0",2,4,1,1,3,9,11
"1216","South Sudan","Africa","c",2017,"NF",7,7,1,1,0,4,"0",-2,4,2,0,0,6,4
"1217","Spain","Europe","c",2017,"F",1,1,12,16,10,0,"0",38,15,11,15,15,56,94
"1218","Sri Lanka","Asia","c",2017,"PF",3,4,8,10,7,1,"0",24,9,8,7,8,32,56
"1219","St. Kitts and Nevis","Americas","c",2017,"F",1,1,10,16,10,0,"0",36,15,12,13,13,53,89
"1220","St. Lucia","Americas","c",2017,"F",1,1,12,16,11,0,"0",39,15,12,12,14,53,92
"1221","St. Vincent and the Grenadines","Americas","c",2017,"F",1,1,11,16,10,0,"0",37,15,12,13,14,54,91
"1222","Sudan","Africa","c",2017,"NF",7,7,2,3,1,4,"0",2,2,1,0,1,4,6
"1223","Suriname","Americas","c",2017,"F",2,3,12,14,8,0,"0",34,15,11,7,10,43,77
"1224","Swaziland","Africa","c",2017,"NF",7,5,0,1,0,0,"0",1,7,2,4,4,17,18
"1225","Sweden","Europe","c",2017,"F",1,1,12,16,12,0,"0",40,16,12,16,16,60,100
"1226","Switzerland","Europe","c",2017,"F",1,1,12,15,12,0,"0",39,15,12,15,15,57,96
"1227","Syria","Middle East","c",2017,"NF",7,7,0,0,0,3,"0",-3,2,0,0,0,2,-1
"1228","Taiwan","Asia","c",2017,"F",1,1,12,15,10,0,"0",37,16,11,14,13,54,91
"1229","Tajikistan","Eurasia","c",2017,"NF",7,6,0,0,1,0,"0",1,2,2,2,4,10,11
"1230","Tanzania","Africa","c",2017,"PF",3,4,7,11,7,0,"0",25,9,6,9,9,33,58
"1231","Thailand","Asia","c",2017,"NF",6,5,1,3,3,0,"0",7,6,4,5,10,25,32
"1232","The Gambia","Africa","c",2017,"NF",6,6,3,5,0,0,"0",8,3,2,1,6,12,20
"1233","Tibet","Asia","t",2017,"NF",7,7,0,0,1,3,"0",-2,0,0,0,3,3,1
"1234","Timor-Leste","Asia","c",2017,"PF",3,3,11,12,6,0,"0",29,12,8,7,9,36,65
"1235","Togo","Africa","c",2017,"PF",4,4,6,7,5,0,"0",18,9,7,7,7,30,48
"1236","Tonga","Asia","c",2017,"F",2,2,9,14,7,0,"0",30,12,9,11,12,44,74
"1237","Transnistria","Eurasia","t",2017,"NF",6,6,3,5,2,0,"0",10,5,2,2,5,14,24
"1238","Trinidad and Tobago","Americas","c",2017,"F",2,2,11,13,9,0,"0",33,15,11,9,13,48,81
"1239","Tunisia","Africa","c",2017,"F",1,3,11,16,9,0,"0",36,13,9,9,11,42,78
"1240","Turkey","Europe","c",2017,"PF",4,5,8,7,3,0,"0",18,6,3,4,7,20,38
"1241","Turkmenistan","Eurasia","c",2017,"NF",7,7,0,0,0,0,"0",0,1,0,0,3,4,4
"1242","Tuvalu","Asia","c",2017,"F",1,1,12,15,10,0,"0",37,16,12,15,14,57,94
"1243","Uganda","Africa","c",2017,"NF",6,5,3,5,3,0,"0",11,9,4,4,7,24,35
"1244","Ukraine","Eurasia","c",2017,"PF",3,3,9,10,6,0,"0",25,11,9,6,10,36,61
"1245","United Arab Emirates","Middle East","c",2017,"NF",6,6,1,2,2,0,"2",7,4,2,3,4,13,20
"1246","United Kingdom","Europe","c",2017,"F",1,1,12,16,12,0,"0",40,14,12,14,15,55,95
"1247","United States","Americas","c",2017,"F",1,1,11,14,11,0,"0",36,16,10,12,15,53,89
"1248","Uruguay","Americas","c",2017,"F",1,1,12,16,12,0,"0",40,16,12,15,15,58,98
"1249","Uzbekistan","Eurasia","c",2017,"NF",7,7,0,0,0,0,"0",0,0,0,0,3,3,3
"1250","Vanuatu","Asia","c",2017,"F",2,2,10,15,7,0,"0",32,15,11,11,11,48,80
"1251","Venezuela","Americas","c",2017,"NF",6,5,5,6,0,0,"0",11,8,3,1,7,19,30
"1252","Vietnam","Asia","c",2017,"NF",7,5,0,1,2,0,"0",3,4,1,4,8,17,20
"1253","West Bank","Middle East","t",2017,"NF",7,5,2,4,2,3,"0",5,8,5,5,5,23,28
"1254","Western Sahara","Africa","t",2017,"NF",7,7,0,0,0,3,"0",-3,3,0,0,4,7,4
"1255","Yemen","Middle East","c",2017,"NF",7,6,0,1,1,0,"0",2,5,3,2,2,12,14
"1256","Zambia","Africa","c",2017,"PF",4,4,6,11,6,0,"0",23,10,7,8,8,33,56
"1257","Zimbabwe","Africa","c",2017,"PF",5,5,3,6,3,0,"0",12,8,4,3,5,20,32
"1258","Abkhazia","Eurasia","t",2016,"PF",4,5,6,8,5,0,"0",19,8,6,4,5,23,42
"1259","Afghanistan","Asia","c",2016,"NF",6,6,2,6,2,0,"0",10,6,4,2,2,14,24
"1260","Albania","Europe","c",2016,"PF",3,3,8,13,6,0,"0",27,13,9,9,9,40,67
"1261","Algeria","Africa","c",2016,"NF",6,5,4,4,3,0,"0",11,7,5,5,7,24,35
"1262","Andorra","Europe","c",2016,"F",1,1,12,15,12,0,"0",39,16,11,15,15,57,96
"1263","Angola","Africa","c",2016,"NF",6,6,3,6,1,0,"0",10,5,3,3,3,14,24
"1264","Antigua and Barbuda","Americas","c",2016,"F",2,2,12,13,8,0,"0",33,14,9,13,13,49,82
"1265","Argentina","Americas","c",2016,"F",2,2,11,14,6,0,"0",31,14,11,10,13,48,79
"1266","Armenia","Eurasia","c",2016,"PF",5,4,5,7,4,0,"0",16,9,6,6,9,30,46
"1267","Australia","Asia","c",2016,"F",1,1,12,16,12,0,"0",40,16,12,15,15,58,98
"1268","Austria","Europe","c",2016,"F",1,1,12,15,10,0,"0",37,16,12,15,15,58,95
"1269","Azerbaijan","Eurasia","c",2016,"NF",7,6,1,3,1,0,"0",5,3,1,2,5,11,16
"1270","Bahamas","Americas","c",2016,"F",1,1,12,16,10,0,"0",38,16,12,13,13,54,92
"1271","Bahrain","Middle East","c",2016,"NF",7,6,2,2,3,3,"0",4,2,1,1,6,10,14
"1272","Bangladesh","Asia","c",2016,"PF",4,4,7,9,5,0,"0",21,7,6,6,9,28,49
"1273","Barbados","Americas","c",2016,"F",1,1,12,16,12,0,"0",40,16,12,15,15,58,98
"1274","Belarus","Eurasia","c",2016,"NF",7,6,0,3,1,0,"0",4,3,1,2,7,13,17
"1275","Belgium","Europe","c",2016,"F",1,1,12,16,12,0,"0",40,15,12,14,15,56,96
"1276","Belize","Americas","c",2016,"F",1,2,12,14,10,0,"0",36,15,11,12,13,51,87
"1277","Benin","Africa","c",2016,"F",2,2,9,16,8,0,"0",33,15,12,12,10,49,82
"1278","Bhutan","Asia","c",2016,"PF",3,4,10,10,10,1,"0",29,9,4,6,8,27,56
"1279","Bolivia","Americas","c",2016,"PF",3,3,11,11,7,0,"0",29,14,9,6,10,39,68
"1280","Bosnia and Herzegovina","Europe","c",2016,"PF",4,3,8,10,4,0,"0",22,10,7,8,10,35,57
"1281","Botswana","Africa","c",2016,"F",3,2,10,10,8,0,"0",28,12,10,12,11,45,73
"1282","Brazil","Americas","c",2016,"F",2,2,11,14,8,0,"0",33,15,10,10,13,48,81
"1283","Brunei","Asia","c",2016,"NF",6,5,0,3,3,0,"1",7,6,3,6,7,22,29
"1284","Bulgaria","Europe","c",2016,"F",2,2,11,14,8,0,"0",33,14,11,10,12,47,80
"1285","Burkina Faso","Africa","c",2016,"PF",4,3,6,9,6,0,"0",21,14,8,8,8,38,59
"1286","Burundi","Africa","c",2016,"NF",7,6,1,4,0,0,"0",5,6,2,1,5,14,19
"1287","Cambodia","Asia","c",2016,"NF",6,5,4,4,3,0,"0",11,9,3,3,6,21,32
"1288","Cameroon","Africa","c",2016,"NF",6,6,3,3,3,0,"0",9,7,3,1,4,15,24
"1289","Canada","Americas","c",2016,"F",1,1,12,16,12,0,"0",40,16,12,15,16,59,99
"1290","Cape Verde","Africa","c",2016,"F",1,1,12,15,10,0,"0",37,15,11,14,13,53,90
"1291","Central African Republic","Africa","c",2016,"NF",7,7,1,1,0,1,"0",1,4,1,0,1,6,7
"1292","Chad","Africa","c",2016,"NF",7,6,2,1,1,0,"0",4,7,5,1,3,16,20
"1293","Chile","Americas","c",2016,"F",1,1,12,15,11,0,"0",38,16,12,14,15,57,95
"1294","China","Asia","c",2016,"NF",7,6,0,1,2,2,"0",1,4,3,2,6,15,16
"1295","Colombia","Americas","c",2016,"PF",3,4,10,11,8,0,"0",29,12,5,7,10,34,63
"1296","Comoros","Africa","c",2016,"PF",3,4,9,11,4,0,"0",24,10,7,8,6,31,55
"1297","Congo (Brazzaville)","Africa","c",2016,"NF",6,5,1,2,3,0,"0",6,7,6,2,7,22,28
"1298","Congo (Kinshasa)","Africa","c",2016,"NF",6,6,3,4,2,0,"0",9,8,3,0,5,16,25
"1299","Costa Rica","Americas","c",2016,"F",1,1,12,15,10,0,"0",37,16,11,13,13,53,90
"1300","Cote d'Ivoire","Africa","c",2016,"PF",4,4,7,8,5,0,"0",20,11,7,6,7,31,51
"1301","Crimea","Eurasia","t",2016,"NF",7,6,0,0,0,1,"0",-1,3,1,0,6,10,9
"1302","Croatia","Europe","c",2016,"F",1,2,12,15,10,0,"0",37,14,12,11,13,50,87
"1303","Cuba","Americas","c",2016,"NF",7,6,0,0,1,0,"0",1,5,0,3,6,14,15
"1304","Cyprus","Europe","c",2016,"F",1,1,11,16,11,0,"0",38,15,12,15,14,56,94
"1305","Czech Republic","Europe","c",2016,"F",1,1,12,15,11,0,"0",38,16,12,14,15,57,95
"1306","Denmark","Europe","c",2016,"F",1,1,12,16,12,0,"0",40,16,12,15,15,58,98
"1307","Djibouti","Africa","c",2016,"NF",6,5,3,3,3,0,"0",9,6,3,4,6,19,28
"1308","Dominica","Americas","c",2016,"F",1,1,12,16,10,0,"0",38,15,12,15,15,57,95
"1309","Dominican Republic","Americas","c",2016,"PF",3,3,10,10,9,0,"0",29,14,10,8,9,41,70
"1310","Ecuador","Americas","c",2016,"PF",3,3,7,11,6,0,"0",24,12,7,6,10,35,59
"1311","Egypt","Africa","c",2016,"NF",6,5,3,4,2,0,"0",9,5,4,2,7,18,27
"1312","El Salvador","Americas","c",2016,"F",2,3,10,14,9,0,"0",33,12,8,8,8,36,69
"1313","Equatorial Guinea","Africa","c",2016,"NF",7,7,0,1,0,0,"0",1,4,0,0,3,7,8
"1314","Eritrea","Africa","c",2016,"NF",7,7,0,0,1,0,"0",1,0,0,0,2,2,3
"1315","Estonia","Europe","c",2016,"F",1,1,12,15,11,0,"0",38,16,12,14,14,56,94
"1316","Ethiopia","Africa","c",2016,"NF",7,6,1,0,3,0,"0",4,3,0,3,5,11,15
"1317","Fiji","Asia","c",2016,"PF",3,3,9,11,7,0,"0",27,11,5,9,10,35,62
"1318","Finland","Europe","c",2016,"F",1,1,12,16,12,0,"0",40,16,12,16,16,60,100
"1319","France","Europe","c",2016,"F",1,1,12,15,11,0,"0",38,14,11,13,15,53,91
"1320","Gabon","Africa","c",2016,"NF",6,5,2,4,3,0,"0",9,10,4,6,5,25,34
"1321","Gaza Strip","Middle East","t",2016,"NF",7,6,0,2,1,0,"0",3,4,3,0,2,9,12
"1322","Georgia","Eurasia","c",2016,"PF",3,3,9,11,7,0,"0",27,11,8,8,10,37,64
"1323","Germany","Europe","c",2016,"F",1,1,12,15,12,0,"0",39,15,12,14,15,56,95
"1324","Ghana","Africa","c",2016,"F",1,2,12,15,10,0,"0",37,14,11,11,10,46,83
"1325","Greece","Europe","c",2016,"F",2,2,12,15,8,0,"0",35,14,11,10,13,48,83
"1326","Grenada","Americas","c",2016,"F",1,2,12,16,10,0,"0",38,15,11,12,13,51,89
"1327","Guatemala","Americas","c",2016,"PF",4,4,8,10,5,0,"0",23,12,6,5,8,31,54
"1328","Guinea","Africa","c",2016,"PF",5,5,6,8,3,0,"0",17,9,5,4,5,23,40
"1329","Guinea-Bissau","Africa","c",2016,"PF",5,5,7,8,1,0,"0",16,10,5,3,5,23,39
"1330","Guyana","Americas","c",2016,"F",2,3,11,13,8,0,"0",32,15,10,8,9,42,74
"1331","Haiti","Americas","c",2016,"PF",5,5,4,8,5,0,"0",17,10,4,4,6,24,41
"1332","Honduras","Americas","c",2016,"PF",4,4,7,9,3,0,"0",19,9,5,4,8,26,45
"1333","Hong Kong","Asia","t",2016,"PF",5,2,3,7,6,0,"0",16,12,8,14,13,47,63
"1334","Hungary","Europe","c",2016,"F",2,2,9,15,8,0,"0",32,13,11,10,13,47,79
"1335","Iceland","Europe","c",2016,"F",1,1,12,16,12,0,"0",40,16,12,16,16,60,100
"1336","India","Asia","c",2016,"F",2,3,12,14,9,0,"0",35,13,10,9,10,42,77
"1337","Indian Kashmir","Asia","t",2016,"PF",4,4,9,9,4,0,"0",22,9,6,6,8,29,51
"1338","Indonesia","Asia","c",2016,"PF",2,4,11,14,6,0,"0",31,12,8,5,9,34,65
"1339","Iran","Middle East","c",2016,"NF",6,6,3,2,2,0,"0",7,2,1,3,4,10,17
"1340","Iraq","Middle East","c",2016,"NF",5,6,8,5,2,3,"0",12,5,6,0,4,15,27
"1341","Ireland","Europe","c",2016,"F",1,1,12,16,11,0,"0",39,16,12,14,15,57,96
"1342","Israel","Middle East","c",2016,"F",1,2,12,14,10,0,"0",36,12,10,11,11,44,80
"1343","Italy","Europe","c",2016,"F",1,1,12,14,10,0,"0",36,15,12,12,14,53,89
"1344","Jamaica","Americas","c",2016,"F",2,3,12,13,9,0,"0",34,15,9,7,10,41,75
"1345","Japan","Asia","c",2016,"F",1,1,12,16,12,0,"0",40,15,12,15,14,56,96
"1346","Jordan","Middle East","c",2016,"NF",6,5,2,6,3,0,"0",11,7,4,6,8,25,36
"1347","Kazakhstan","Eurasia","c",2016,"NF",6,5,2,3,1,0,"0",6,4,2,4,8,18,24
"1348","Kenya","Africa","c",2016,"PF",4,4,7,10,5,0,"0",22,11,6,5,7,29,51
"1349","Kiribati","Asia","c",2016,"F",1,1,12,16,8,0,"0",36,15,12,15,13,55,91
"1350","Kosovo","Europe","c",2016,"PF",3,4,9,10,5,0,"0",24,9,6,6,7,28,52
"1351","Kuwait","Middle East","c",2016,"PF",5,5,2,7,4,0,"0",13,6,4,7,6,23,36
"1352","Kyrgyzstan","Eurasia","c",2016,"PF",5,5,6,6,4,2,"0",14,9,4,4,7,24,38
"1353","Laos","Asia","c",2016,"NF",7,6,0,0,1,0,"0",1,4,0,2,5,11,12
"1354","Latvia","Europe","c",2016,"F",2,2,12,14,9,0,"0",35,15,12,12,12,51,86
"1355","Lebanon","Middle East","c",2016,"PF",5,4,2,9,2,0,"0",13,11,7,5,7,30,43
"1356","Lesotho","Africa","c",2016,"PF",3,3,10,12,6,0,"0",28,14,7,9,9,39,67
"1357","Liberia","Africa","c",2016,"PF",3,4,9,12,7,0,"0",28,10,8,7,8,33,61
"1358","Libya","Africa","c",2016,"NF",6,6,4,2,0,0,"0",6,6,3,1,4,14,20
"1359","Liechtenstein","Europe","c",2016,"F",1,1,12,15,12,0,"0",39,16,12,15,16,59,98
"1360","Lithuania","Europe","c",2016,"F",1,1,12,16,10,0,"0",38,16,11,13,13,53,91
"1361","Luxembourg","Europe","c",2016,"F",1,1,12,16,10,0,"0",38,16,12,16,16,60,98
"1362","Macedonia","Europe","c",2016,"PF",4,3,6,10,6,0,"0",22,10,8,7,10,35,57
"1363","Madagascar","Africa","c",2016,"PF",3,4,9,10,5,0,"0",24,10,8,6,8,32,56
"1364","Malawi","Africa","c",2016,"PF",3,3,8,12,7,0,"0",27,13,8,9,7,37,64
"1365","Malaysia","Asia","c",2016,"PF",4,4,6,7,5,0,"0",18,7,6,5,9,27,45
"1366","Maldives","Asia","c",2016,"PF",4,5,7,6,6,0,"0",19,6,5,6,7,24,43
"1367","Mali","Africa","c",2016,"PF",5,4,6,7,4,0,"0",17,12,6,6,4,28,45
"1368","Malta","Europe","c",2016,"F",1,1,12,16,11,0,"0",39,16,12,15,14,57,96
"1369","Marshall Islands","Asia","c",2016,"F",1,1,12,15,10,0,"0",37,16,11,15,13,55,92
"1370","Mauritania","Africa","c",2016,"NF",6,5,3,2,4,0,"0",9,9,4,4,4,21,30
"1371","Mauritius","Africa","c",2016,"F",1,2,12,15,11,0,"0",38,15,12,13,12,52,90
"1372","Mexico","Americas","c",2016,"PF",3,3,9,12,7,0,"0",28,13,8,6,10,37,65
"1373","Micronesia","Asia","c",2016,"F",1,1,12,15,10,0,"0",37,16,11,15,14,56,93
"1374","Moldova","Eurasia","c",2016,"PF",3,3,10,11,4,0,"0",25,11,8,7,9,35,60
"1375","Monaco","Europe","c",2016,"F",2,1,10,11,10,0,"0",31,16,12,15,14,57,88
"1376","Mongolia","Asia","c",2016,"F",1,2,11,16,9,0,"0",36,15,11,12,12,50,86
"1377","Montenegro","Europe","c",2016,"PF",3,3,9,11,7,0,"0",27,12,9,10,12,43,70
"1378","Morocco","Africa","c",2016,"PF",5,4,5,7,3,0,"0",15,8,5,6,7,26,41
"1379","Mozambique","Africa","c",2016,"PF",4,4,6,10,6,0,"0",22,11,7,7,9,34,56
"1380","Myanmar","Asia","c",2016,"NF",6,5,3,8,3,3,"0",11,7,4,1,5,17,28
"1381","Nagorno-Karabakh","Eurasia","t",2016,"PF",5,5,6,6,3,0,"0",15,6,3,4,5,18,33
"1382","Namibia","Africa","c",2016,"F",2,2,10,11,9,0,"0",30,14,12,11,10,47,77
"1383","Nauru","Asia","c",2016,"F",2,2,12,15,8,0,"0",35,13,10,12,14,49,84
"1384","Nepal","Asia","c",2016,"PF",3,4,9,11,5,0,"0",25,9,5,5,7,26,51
"1385","Netherlands","Europe","c",2016,"F",1,1,12,16,12,0,"0",40,16,12,15,16,59,99
"1386","New Zealand","Asia","c",2016,"F",1,1,12,16,12,0,"0",40,16,12,15,15,58,98
"1387","Nicaragua","Americas","c",2016,"PF",4,3,6,7,6,0,"0",19,12,6,7,10,35,54
"1388","Niger","Africa","c",2016,"PF",3,4,8,9,7,0,"0",24,11,6,5,6,28,52
"1389","Nigeria","Africa","c",2016,"PF",4,5,9,10,5,1,"0",23,9,7,4,5,25,48
"1390","North Korea","Asia","c",2016,"NF",7,7,0,0,0,0,"0",0,0,0,0,3,3,3
"1391","Northern Cyprus","Europe","t",2016,"F",2,2,11,12,9,0,"0",32,14,9,12,12,47,79
"1392","Norway","Europe","c",2016,"F",1,1,12,16,12,0,"0",40,16,12,16,16,60,100
"1393","Oman","Middle East","c",2016,"NF",6,5,2,2,2,0,"2",8,5,3,4,5,17,25
"1394","Pakistan","Asia","c",2016,"PF",4,5,7,8,5,0,"0",20,5,6,4,6,21,41
"1395","Pakistani Kashmir","Asia","t",2016,"NF",6,5,4,4,3,2,"0",9,6,4,3,6,19,28
"1396","Palau","Asia","c",2016,"F",1,1,12,15,10,0,"0",37,16,11,15,13,55,92
"1397","Panama","Americas","c",2016,"F",2,2,12,15,8,0,"0",35,15,11,10,12,48,83
"1398","Papua New Guinea","Asia","c",2016,"PF",4,3,9,10,4,0,"0",23,12,9,7,8,36,59
"1399","Paraguay","Americas","c",2016,"PF",3,3,10,12,5,0,"0",27,12,8,7,10,37,64
"1400","Peru","Americas","c",2016,"F",2,3,10,13,7,0,"0",30,15,8,8,10,41,71
"1401","Philippines","Asia","c",2016,"PF",3,3,9,11,7,0,"0",27,14,9,5,10,38,65
"1402","Poland","Europe","c",2016,"F",1,1,12,16,10,0,"0",38,16,12,13,14,55,93
"1403","Portugal","Europe","c",2016,"F",1,1,12,16,11,0,"0",39,16,12,15,15,58,97
"1404","Puerto Rico","Americas","t",2016,"F",1,1,12,15,10,0,"0",37,16,11,12,14,53,90
"1405","Qatar","Middle East","c",2016,"NF",6,5,2,2,3,0,"2",9,8,2,4,4,18,27
"1406","Romania","Europe","c",2016,"F",2,2,11,14,9,0,"0",34,14,11,12,12,49,83
"1407","Russia","Eurasia","c",2016,"NF",6,6,1,3,3,0,"0",7,3,3,2,7,15,22
"1408","Rwanda","Africa","c",2016,"NF",6,6,2,1,5,0,"0",8,4,2,3,7,16,24
"1409","Samoa","Asia","c",2016,"F",2,2,9,13,9,0,"0",31,14,10,13,12,49,80
"1410","San Marino","Europe","c",2016,"F",1,1,12,16,12,0,"0",40,16,12,16,16,60,100
"1411","Sao Tome and Principe","Africa","c",2016,"F",2,2,11,14,9,0,"0",34,15,10,12,10,47,81
"1412","Saudi Arabia","Middle East","c",2016,"NF",7,7,0,0,1,0,"2",3,3,0,2,2,7,10
"1413","Senegal","Africa","c",2016,"F",2,2,11,13,9,0,"0",33,15,10,10,10,45,78
"1414","Serbia","Europe","c",2016,"F",2,2,10,13,7,0,"0",30,14,11,10,13,48,78
"1415","Seychelles","Africa","c",2016,"PF",3,3,9,10,7,0,"0",26,11,9,11,11,42,68
"1416","Sierra Leone","Africa","c",2016,"PF",3,3,10,11,7,0,"0",28,12,7,9,9,37,65
"1417","Singapore","Asia","c",2016,"PF",4,4,4,8,7,0,"0",19,9,4,7,12,32,51
"1418","Slovakia","Europe","c",2016,"F",1,1,12,15,9,0,"0",36,15,12,12,14,53,89
"1419","Slovenia","Europe","c",2016,"F",1,1,12,16,11,0,"0",39,14,12,14,13,53,92
"1420","Solomon Islands","Asia","c",2016,"PF",3,3,9,10,6,0,"0",25,14,9,8,12,43,68
"1421","Somalia","Africa","c",2016,"NF",7,7,0,0,0,0,"0",0,1,0,0,1,2,2
"1422","Somaliland","Africa","t",2016,"PF",5,5,2,9,4,0,"0",15,7,5,7,6,25,40
"1423","South Africa","Africa","c",2016,"F",2,2,12,13,8,0,"0",33,15,12,9,10,46,79
"1424","South Korea","Asia","c",2016,"F",2,2,11,13,10,0,"0",34,12,11,13,13,49,83
"1425","South Ossetia","Eurasia","t",2016,"NF",7,6,2,2,0,2,"0",2,4,1,1,3,9,11
"1426","South Sudan","Africa","c",2016,"NF",7,6,3,1,1,3,"0",2,4,3,1,4,12,14
"1427","Spain","Europe","c",2016,"F",1,1,12,16,11,0,"0",39,15,11,15,15,56,95
"1428","Sri Lanka","Asia","c",2016,"PF",4,4,8,10,6,1,"0",23,9,8,7,8,32,55
"1429","St. Kitts and Nevis","Americas","c",2016,"F",2,1,10,16,9,0,"0",35,15,12,13,13,53,88
"1430","St. Lucia","Americas","c",2016,"F",1,1,12,16,11,0,"0",39,15,12,12,14,53,92
"1431","St. Vincent and the Grenadines","Americas","c",2016,"F",1,1,11,16,10,0,"0",37,15,12,13,14,54,91
"1432","Sudan","Africa","c",2016,"NF",7,7,2,3,1,4,"0",2,2,1,0,1,4,6
"1433","Suriname","Americas","c",2016,"F",2,3,12,14,8,0,"0",34,15,11,7,10,43,77
"1434","Swaziland","Africa","c",2016,"NF",7,5,0,1,0,0,"0",1,7,2,4,4,17,18
"1435","Sweden","Europe","c",2016,"F",1,1,12,16,12,0,"0",40,16,12,16,16,60,100
"1436","Switzerland","Europe","c",2016,"F",1,1,12,15,12,0,"0",39,15,12,15,15,57,96
"1437","Syria","Middle East","c",2016,"NF",7,7,0,0,0,3,"0",-3,2,0,0,0,2,-1
"1438","Taiwan","Asia","c",2016,"F",1,2,12,15,10,0,"0",37,14,11,14,13,52,89
"1439","Tajikistan","Eurasia","c",2016,"NF",7,6,1,0,1,0,"0",2,4,3,3,4,14,16
"1440","Tanzania","Africa","c",2016,"PF",3,4,8,12,7,0,"0",27,9,6,9,9,33,60
"1441","Thailand","Asia","c",2016,"NF",6,5,1,3,3,0,"0",7,6,4,5,10,25,32
"1442","The Gambia","Africa","c",2016,"NF",7,6,1,4,0,0,"0",5,3,3,1,6,13,18
"1443","Tibet","Asia","t",2016,"NF",7,7,0,0,1,3,"0",-2,0,0,0,3,3,1
"1444","Timor-Leste","Asia","c",2016,"PF",3,3,11,12,6,0,"0",29,12,8,7,9,36,65
"1445","Togo","Africa","c",2016,"PF",4,4,6,7,5,0,"0",18,9,7,7,7,30,48
"1446","Tonga","Asia","c",2016,"F",2,2,11,14,6,0,"0",31,13,8,11,12,44,75
"1447","Transnistria","Eurasia","t",2016,"NF",6,6,3,5,2,0,"0",10,5,2,2,5,14,24
"1448","Trinidad and Tobago","Americas","c",2016,"F",2,2,11,13,9,0,"0",33,15,11,9,13,48,81
"1449","Tunisia","Africa","c",2016,"F",1,3,12,16,9,0,"0",37,13,9,9,11,42,79
"1450","Turkey","Europe","c",2016,"PF",3,4,9,9,6,0,"0",24,8,6,6,9,29,53
"1451","Turkmenistan","Eurasia","c",2016,"NF",7,7,0,0,0,0,"0",0,1,0,0,3,4,4
"1452","Tuvalu","Asia","c",2016,"F",1,1,12,15,10,0,"0",37,16,12,15,14,57,94
"1453","Uganda","Africa","c",2016,"NF",6,5,3,5,3,0,"0",11,9,4,5,7,25,36
"1454","Ukraine","Eurasia","c",2016,"PF",3,3,9,10,6,0,"0",25,11,9,6,10,36,61
"1455","United Arab Emirates","Middle East","c",2016,"NF",6,6,1,2,2,0,"2",7,4,2,3,4,13,20
"1456","United Kingdom","Europe","c",2016,"F",1,1,12,16,12,0,"0",40,13,12,15,15,55,95
"1457","United States","Americas","c",2016,"F",1,1,11,15,10,0,"0",36,15,11,13,15,54,90
"1458","Uruguay","Americas","c",2016,"F",1,1,12,16,12,0,"0",40,16,12,15,15,58,98
"1459","Uzbekistan","Eurasia","c",2016,"NF",7,7,0,0,0,0,"0",0,0,0,0,3,3,3
"1460","Vanuatu","Asia","c",2016,"F",2,2,9,15,7,0,"0",31,15,11,10,11,47,78
"1461","Venezuela","Americas","c",2016,"PF",5,5,5,8,2,0,"0",15,8,3,1,8,20,35
"1462","Vietnam","Asia","c",2016,"NF",7,5,0,1,2,0,"0",3,4,1,4,8,17,20
"1463","West Bank","Middle East","t",2016,"NF",6,5,2,5,2,3,"0",6,9,5,5,5,24,30
"1464","Western Sahara","Africa","t",2016,"NF",7,7,0,0,0,3,"0",-3,3,0,0,4,7,4
"1465","Yemen","Middle East","c",2016,"NF",7,6,2,1,1,0,"0",4,5,3,2,3,13,17
"1466","Zambia","Africa","c",2016,"PF",3,4,8,11,7,0,"0",26,11,7,8,8,34,60
"1467","Zimbabwe","Africa","c",2016,"PF",5,5,3,6,3,0,"0",12,8,4,3,5,20,32
"1468","Abkhazia","Eurasia","t",2015,"PF",4,5,6,8,4,0,"0",18,8,6,4,5,23,41
"1469","Afghanistan","Asia","c",2015,"NF",6,6,3,6,2,0,"0",11,5,4,2,2,13,24
"1470","Albania","Europe","c",2015,"PF",3,3,8,13,6,0,"0",27,13,9,9,9,40,67
"1471","Algeria","Africa","c",2015,"NF",6,5,4,4,3,0,"0",11,7,4,5,7,23,34
"1472","Andorra","Europe","c",2015,"F",1,1,12,15,12,0,"0",39,16,11,15,15,57,96
"1473","Angola","Africa","c",2015,"NF",6,5,3,6,1,0,"0",10,7,4,4,3,18,28
"1474","Antigua and Barbuda","Americas","c",2015,"F",2,2,11,13,7,0,"0",31,14,9,13,13,49,80
"1475","Argentina","Americas","c",2015,"F",2,2,11,14,6,0,"0",31,14,11,11,13,49,80
"1476","Armenia","Eurasia","c",2015,"PF",5,4,5,7,4,0,"0",16,9,6,6,9,30,46
"1477","Australia","Asia","c",2015,"F",1,1,12,15,12,0,"0",39,16,12,15,15,58,97
"1478","Austria","Europe","c",2015,"F",1,1,12,15,11,0,"0",38,16,12,15,15,58,96
"1479","Azerbaijan","Eurasia","c",2015,"NF",6,6,1,3,2,0,"0",6,4,1,3,6,14,20
"1480","Bahamas","Americas","c",2015,"F",1,1,12,16,10,0,"0",38,16,12,15,15,58,96
"1481","Bahrain","Middle East","c",2015,"NF",7,6,2,2,3,2,"0",5,2,1,1,6,10,15
"1482","Bangladesh","Asia","c",2015,"PF",4,4,7,9,5,0,"0",21,8,6,6,9,29,50
"1483","Barbados","Americas","c",2015,"F",1,1,12,16,12,0,"0",40,16,12,16,15,59,99
"1484","Belarus","Eurasia","c",2015,"NF",7,6,0,3,1,0,"0",4,3,1,1,5,10,14
"1485","Belgium","Europe","c",2015,"F",1,1,12,16,12,0,"0",40,15,12,15,15,57,97
"1486","Belize","Americas","c",2015,"F",1,2,12,14,10,0,"0",36,15,11,12,13,51,87
"1487","Benin","Africa","c",2015,"F",2,2,8,16,8,0,"0",32,15,12,12,10,49,81
"1488","Bhutan","Asia","c",2015,"PF",3,4,10,10,10,1,"0",29,9,4,6,8,27,56
"1489","Bolivia","Americas","c",2015,"PF",3,3,11,11,7,0,"0",29,14,9,6,10,39,68
"1490","Bosnia and Herzegovina","Europe","c",2015,"PF",4,3,8,10,5,0,"0",23,10,7,10,10,37,60
"1491","Botswana","Africa","c",2015,"F",3,2,10,10,8,0,"0",28,12,10,12,11,45,73
"1492","Brazil","Americas","c",2015,"F",2,2,11,14,8,0,"0",33,15,10,10,13,48,81
"1493","Brunei","Asia","c",2015,"NF",6,5,0,3,3,0,"1",7,6,3,6,8,23,30
"1494","Bulgaria","Europe","c",2015,"F",2,2,11,14,8,0,"0",33,14,11,10,11,46,79
"1495","Burkina Faso","Africa","c",2015,"PF",6,3,2,6,1,0,"0",9,13,8,7,8,36,45
"1496","Burundi","Africa","c",2015,"NF",6,5,4,5,2,0,"0",11,8,3,4,6,21,32
"1497","Cambodia","Asia","c",2015,"NF",6,5,4,4,3,0,"0",11,9,3,2,6,20,31
"1498","Cameroon","Africa","c",2015,"NF",6,6,3,3,3,0,"0",9,7,3,2,4,16,25
"1499","Canada","Americas","c",2015,"F",1,1,12,16,11,0,"0",39,16,12,15,16,59,98
"1500","Cape Verde","Africa","c",2015,"F",1,1,12,15,10,0,"0",37,15,11,14,13,53,90
"1501","Central African Republic","Africa","c",2015,"NF",7,7,0,1,0,1,"0",0,4,1,0,1,6,6
"1502","Chad","Africa","c",2015,"NF",7,6,3,1,1,0,"0",5,7,4,2,3,16,21
"1503","Chile","Americas","c",2015,"F",1,1,12,15,12,0,"0",39,16,11,14,15,56,95
"1504","China","Asia","c",2015,"NF",7,6,0,1,2,1,"0",2,4,3,2,6,15,17
"1505","Colombia","Americas","c",2015,"PF",3,4,10,11,8,0,"0",29,12,5,7,10,34,63
"1506","Comoros","Africa","c",2015,"PF",3,4,9,11,5,0,"0",25,10,6,8,6,30,55
"1507","Congo (Brazzaville)","Africa","c",2015,"NF",6,5,1,3,3,0,"0",7,8,6,2,7,23,30
"1508","Congo (Kinshasa)","Africa","c",2015,"NF",6,6,3,4,2,0,"0",9,8,3,0,5,16,25
"1509","Costa Rica","Americas","c",2015,"F",1,1,12,15,10,0,"0",37,16,11,13,13,53,90
"1510","Cote d'Ivoire","Africa","c",2015,"PF",5,4,6,7,4,0,"0",17,10,7,6,6,29,46
"1511","Crimea","Eurasia","t",2015,"NF",7,6,0,0,0,1,"0",-1,3,1,0,7,11,10
"1512","Croatia","Europe","c",2015,"F",1,2,12,15,9,0,"0",36,14,12,11,13,50,86
"1513","Cuba","Americas","c",2015,"NF",7,6,0,0,1,0,"0",1,4,0,3,6,13,14
"1514","Cyprus","Europe","c",2015,"F",1,1,11,16,10,0,"0",37,15,12,15,14,56,93
"1515","Czech Republic","Europe","c",2015,"F",1,1,12,15,11,0,"0",38,16,12,14,15,57,95
"1516","Denmark","Europe","c",2015,"F",1,1,12,16,12,0,"0",40,16,12,15,15,58,98
"1517","Djibouti","Africa","c",2015,"NF",6,5,3,3,3,0,"0",9,6,3,4,6,19,28
"1518","Dominica","Americas","c",2015,"F",1,1,12,16,10,0,"0",38,15,12,15,15,57,95
"1519","Dominican Republic","Americas","c",2015,"F",2,3,10,11,9,0,"0",30,15,10,8,10,43,73
"1520","Ecuador","Americas","c",2015,"PF",3,3,7,11,6,0,"0",24,12,7,6,10,35,59
"1521","Egypt","Africa","c",2015,"NF",6,5,2,4,2,0,"0",8,5,4,2,7,18,26
"1522","El Salvador","Americas","c",2015,"F",2,3,12,14,9,0,"0",35,15,8,8,9,40,75
"1523","Equatorial Guinea","Africa","c",2015,"NF",7,7,0,1,0,0,"0",1,4,0,0,3,7,8
"1524","Eritrea","Africa","c",2015,"NF",7,7,0,0,1,0,"0",1,0,0,0,2,2,3
"1525","Estonia","Europe","c",2015,"F",1,1,12,15,12,0,"0",39,16,12,14,14,56,95
"1526","Ethiopia","Africa","c",2015,"NF",6,6,1,2,4,0,"0",7,3,0,3,5,11,18
"1527","Fiji","Asia","c",2015,"PF",3,4,9,11,6,0,"0",26,11,4,9,10,34,60
"1528","Finland","Europe","c",2015,"F",1,1,12,16,12,0,"0",40,16,12,16,16,60,100
"1529","France","Europe","c",2015,"F",1,1,12,15,11,0,"0",38,15,12,15,15,57,95
"1530","Gabon","Africa","c",2015,"NF",6,5,2,4,3,0,"0",9,10,4,6,5,25,34
"1531","Gaza Strip","Middle East","t",2015,"NF",7,6,2,2,1,0,"0",5,5,3,0,2,10,15
"1532","Georgia","Eurasia","c",2015,"PF",3,3,9,10,7,0,"0",26,12,8,8,10,38,64
"1533","Germany","Europe","c",2015,"F",1,1,12,15,12,0,"0",39,15,12,15,15,57,96
"1534","Ghana","Africa","c",2015,"F",1,2,12,15,10,0,"0",37,14,11,12,10,47,84
"1535","Greece","Europe","c",2015,"F",2,2,12,15,8,0,"0",35,14,11,10,13,48,83
"1536","Grenada","Americas","c",2015,"F",1,2,12,16,10,0,"0",38,15,11,12,13,51,89
"1537","Guatemala","Americas","c",2015,"PF",3,4,9,10,5,0,"0",24,12,6,5,8,31,55
"1538","Guinea","Africa","c",2015,"PF",5,5,6,8,3,0,"0",17,9,6,4,5,24,41
"1539","Guinea-Bissau","Africa","c",2015,"PF",5,5,8,8,1,0,"0",17,10,5,3,5,23,40
"1540","Guyana","Americas","c",2015,"F",2,3,11,13,6,0,"0",30,15,10,7,9,41,71
"1541","Haiti","Americas","c",2015,"PF",5,5,4,8,5,0,"0",17,10,4,4,6,24,41
"1542","Honduras","Americas","c",2015,"PF",4,4,7,9,4,0,"0",20,10,6,5,8,29,49
"1543","Hong Kong","Asia","t",2015,"PF",5,2,3,7,6,0,"0",16,13,8,15,13,49,65
"1544","Hungary","Europe","c",2015,"F",2,2,9,15,8,0,"0",32,14,11,11,14,50,82
"1545","Iceland","Europe","c",2015,"F",1,1,12,16,11,0,"0",39,16,12,16,16,60,99
"1546","India","Asia","c",2015,"F",2,3,12,14,9,0,"0",35,13,11,9,10,43,78
"1547","Indian Kashmir","Asia","t",2015,"PF",4,4,9,9,4,0,"0",22,9,6,6,8,29,51
"1548","Indonesia","Asia","c",2015,"PF",2,4,10,14,6,0,"0",30,12,8,5,9,34,64
"1549","Iran","Middle East","c",2015,"NF",6,6,3,2,2,0,"0",7,2,1,3,4,10,17
"1550","Iraq","Middle East","c",2015,"NF",6,6,8,5,1,3,"0",11,5,4,0,4,13,24
"1551","Ireland","Europe","c",2015,"F",1,1,12,16,11,0,"0",39,16,12,15,15,58,97
"1552","Israel","Middle East","c",2015,"F",1,2,12,14,10,0,"0",36,12,10,11,11,44,80
"1553","Italy","Europe","c",2015,"F",1,1,12,14,10,0,"0",36,15,12,12,14,53,89
"1554","Jamaica","Americas","c",2015,"F",2,3,12,13,9,0,"0",34,15,9,6,10,40,74
"1555","Japan","Asia","c",2015,"F",1,1,12,15,12,0,"0",39,15,11,15,14,55,94
"1556","Jordan","Middle East","c",2015,"NF",6,5,2,6,3,0,"0",11,7,4,6,8,25,36
"1557","Kazakhstan","Eurasia","c",2015,"NF",6,5,2,3,1,0,"0",6,4,2,4,8,18,24
"1558","Kenya","Africa","c",2015,"PF",4,4,7,10,5,0,"0",22,11,6,5,7,29,51
"1559","Kiribati","Asia","c",2015,"F",1,1,12,16,8,0,"0",36,15,12,15,13,55,91
"1560","Kosovo","Europe","c",2015,"PF",4,4,9,10,4,0,"0",23,9,6,6,8,29,52
"1561","Kuwait","Middle East","c",2015,"PF",5,5,2,7,5,0,"0",14,6,4,7,6,23,37
"1562","Kyrgyzstan","Eurasia","c",2015,"PF",5,5,6,6,4,2,"0",14,9,4,4,7,24,38
"1563","Laos","Asia","c",2015,"NF",7,6,0,0,1,0,"0",1,4,0,2,5,11,12
"1564","Latvia","Europe","c",2015,"F",2,2,12,14,8,0,"0",34,15,12,12,12,51,85
"1565","Lebanon","Middle East","c",2015,"PF",5,4,2,9,3,0,"0",14,11,7,5,7,30,44
"1566","Lesotho","Africa","c",2015,"F",2,3,10,12,8,0,"0",30,14,7,11,9,41,71
"1567","Liberia","Africa","c",2015,"PF",3,4,9,11,6,0,"0",26,10,7,6,7,30,56
"1568","Libya","Africa","c",2015,"NF",6,6,5,3,0,0,"0",8,6,3,1,5,15,23
"1569","Liechtenstein","Europe","c",2015,"F",1,1,12,15,12,0,"0",39,16,12,15,16,59,98
"1570","Lithuania","Europe","c",2015,"F",1,1,12,16,10,0,"0",38,16,11,13,13,53,91
"1571","Luxembourg","Europe","c",2015,"F",1,1,12,16,10,0,"0",38,16,12,16,16,60,98
"1572","Macedonia","Europe","c",2015,"PF",4,3,7,10,6,0,"0",23,11,8,8,10,37,60
"1573","Madagascar","Africa","c",2015,"PF",4,4,9,9,4,0,"0",22,9,8,6,7,30,52
"1574","Malawi","Africa","c",2015,"PF",3,4,8,12,7,0,"0",27,11,7,9,7,34,61
"1575","Malaysia","Asia","c",2015,"PF",4,4,6,7,6,0,"0",19,7,6,5,9,27,46
"1576","Maldives","Asia","c",2015,"PF",4,4,7,7,6,0,"0",20,6,7,7,8,28,48
"1577","Mali","Africa","c",2015,"PF",5,4,6,7,4,0,"0",17,11,6,6,4,27,44
"1578","Malta","Europe","c",2015,"F",1,1,12,16,11,0,"0",39,16,12,15,15,58,97
"1579","Marshall Islands","Asia","c",2015,"F",1,1,11,15,10,0,"0",36,16,11,15,13,55,91
"1580","Mauritania","Africa","c",2015,"NF",6,5,3,2,4,0,"0",9,10,4,4,4,22,31
"1581","Mauritius","Africa","c",2015,"F",1,2,12,15,11,0,"0",38,15,12,13,12,52,90
"1582","Mexico","Americas","c",2015,"PF",3,3,9,12,7,0,"0",28,12,8,6,10,36,64
"1583","Micronesia","Asia","c",2015,"F",1,1,12,15,10,0,"0",37,16,11,15,14,56,93
"1584","Moldova","Eurasia","c",2015,"PF",3,3,10,12,6,0,"0",28,11,8,7,9,35,63
"1585","Monaco","Europe","c",2015,"F",2,1,10,11,10,0,"0",31,16,12,15,14,57,88
"1586","Mongolia","Asia","c",2015,"F",1,2,11,16,9,0,"0",36,15,11,12,12,50,86
"1587","Montenegro","Europe","c",2015,"F",3,2,9,11,7,0,"0",27,12,10,10,12,44,71
"1588","Morocco","Africa","c",2015,"PF",5,4,5,7,3,0,"0",15,8,6,6,7,27,42
"1589","Mozambique","Africa","c",2015,"PF",4,3,6,10,7,0,"0",23,12,7,7,9,35,58
"1590","Myanmar","Asia","c",2015,"NF",6,6,3,6,3,3,"0",9,6,4,1,5,16,25
"1591","Nagorno-Karabakh","Eurasia","t",2015,"PF",5,5,4,5,3,0,"0",12,6,3,4,5,18,30
"1592","Namibia","Africa","c",2015,"F",2,2,10,11,9,0,"0",30,14,12,11,9,46,76
"1593","Nauru","Asia","c",2015,"F",1,2,12,16,9,0,"0",37,14,11,12,14,51,88
"1594","Nepal","Asia","c",2015,"PF",3,4,8,11,5,0,"0",24,9,6,5,7,27,51
"1595","Netherlands","Europe","c",2015,"F",1,1,12,16,12,0,"0",40,16,12,15,16,59,99
"1596","New Zealand","Asia","c",2015,"F",1,1,12,15,12,0,"0",39,16,12,15,15,58,97
"1597","Nicaragua","Americas","c",2015,"PF",4,3,6,7,6,0,"0",19,12,6,7,10,35,54
"1598","Niger","Africa","c",2015,"PF",3,4,9,10,7,0,"0",26,11,8,5,6,30,56
"1599","Nigeria","Africa","c",2015,"PF",4,5,6,9,4,1,"0",18,9,7,4,5,25,43
"1600","North Korea","Asia","c",2015,"NF",7,7,0,0,0,0,"0",0,0,0,0,3,3,3
"1601","Northern Cyprus","Europe","t",2015,"F",2,2,11,12,9,0,"0",32,14,9,12,12,47,79
"1602","Norway","Europe","c",2015,"F",1,1,12,16,12,0,"0",40,16,12,16,16,60,100
"1603","Oman","Middle East","c",2015,"NF",6,5,2,2,2,0,"3",9,5,3,4,5,17,26
"1604","Pakistan","Asia","c",2015,"PF",4,5,7,8,5,0,"0",20,5,7,4,6,22,42
"1605","Pakistani Kashmir","Asia","t",2015,"NF",6,5,4,4,3,2,"0",9,6,4,4,6,20,29
"1606","Palau","Asia","c",2015,"F",1,1,12,15,10,0,"0",37,16,11,15,13,55,92
"1607","Panama","Americas","c",2015,"F",2,2,12,15,8,0,"0",35,15,11,9,12,47,82
"1608","Papua New Guinea","Asia","c",2015,"PF",4,3,9,10,4,0,"0",23,12,9,7,8,36,59
"1609","Paraguay","Americas","c",2015,"PF",3,3,10,12,5,0,"0",27,12,8,7,11,38,65
"1610","Peru","Americas","c",2015,"F",2,3,10,13,7,0,"0",30,15,8,8,10,41,71
"1611","Philippines","Asia","c",2015,"PF",3,3,9,10,7,0,"0",26,14,8,5,10,37,63
"1612","Poland","Europe","c",2015,"F",1,1,12,16,10,0,"0",38,16,12,13,14,55,93
"1613","Portugal","Europe","c",2015,"F",1,1,12,16,11,0,"0",39,16,12,15,15,58,97
"1614","Puerto Rico","Americas","t",2015,"F",1,2,12,15,10,0,"0",37,16,10,12,14,52,89
"1615","Qatar","Middle East","c",2015,"NF",6,5,2,2,3,0,"3",10,8,2,4,4,18,28
"1616","Romania","Europe","c",2015,"F",2,2,11,14,9,0,"0",34,14,11,12,12,49,83
"1617","Russia","Eurasia","c",2015,"NF",6,6,1,3,3,0,"0",7,4,4,2,6,16,23
"1618","Rwanda","Africa","c",2015,"NF",6,6,2,2,5,0,"0",9,4,2,3,7,16,25
"1619","Samoa","Asia","c",2015,"F",2,2,9,13,10,0,"0",32,14,10,13,12,49,81
"1620","San Marino","Europe","c",2015,"F",1,1,12,16,12,0,"0",40,16,12,16,16,60,100
"1621","Sao Tome and Principe","Africa","c",2015,"F",2,2,11,14,9,0,"0",34,15,10,12,10,47,81
"1622","Saudi Arabia","Middle East","c",2015,"NF",7,7,0,0,1,0,"2",3,3,0,2,2,7,10
"1623","Senegal","Africa","c",2015,"F",2,2,11,13,9,0,"0",33,15,10,10,10,45,78
"1624","Serbia","Europe","c",2015,"F",2,2,10,14,7,0,"0",31,15,11,10,13,49,80
"1625","Seychelles","Africa","c",2015,"PF",3,3,8,10,7,0,"0",25,11,9,11,11,42,67
"1626","Sierra Leone","Africa","c",2015,"PF",3,3,10,11,7,0,"0",28,12,7,9,9,37,65
"1627","Singapore","Asia","c",2015,"PF",4,4,4,8,7,0,"0",19,9,4,7,12,32,51
"1628","Slovakia","Europe","c",2015,"F",1,1,12,15,10,0,"0",37,15,12,12,14,53,90
"1629","Slovenia","Europe","c",2015,"F",1,1,12,15,11,0,"0",38,14,12,14,13,53,91
"1630","Solomon Islands","Asia","c",2015,"PF",3,3,9,10,6,0,"0",25,14,9,8,12,43,68
"1631","Somalia","Africa","c",2015,"NF",7,7,0,0,0,0,"0",0,1,0,0,1,2,2
"1632","Somaliland","Africa","t",2015,"PF",4,5,5,10,6,0,"0",21,7,5,7,6,25,46
"1633","South Africa","Africa","c",2015,"F",2,2,12,13,8,0,"0",33,15,12,10,11,48,81
"1634","South Korea","Asia","c",2015,"F",2,2,11,13,10,0,"0",34,13,11,13,13,50,84
"1635","South Ossetia","Eurasia","t",2015,"NF",7,6,2,2,0,3,"0",1,4,1,1,3,9,10
"1636","South Sudan","Africa","c",2015,"NF",7,6,3,0,1,2,"0",2,4,3,1,5,13,15
"1637","Spain","Europe","c",2015,"F",1,1,12,16,11,0,"0",39,15,12,15,15,57,96
"1638","Sri Lanka","Asia","c",2015,"PF",5,5,6,7,4,1,"0",16,6,6,5,8,25,41
"1639","St. Kitts and Nevis","Americas","c",2015,"F",1,1,12,16,9,0,"0",37,15,12,13,13,53,90
"1640","St. Lucia","Americas","c",2015,"F",1,1,12,16,11,0,"0",39,15,12,12,14,53,92
"1641","St. Vincent and the Grenadines","Americas","c",2015,"F",1,1,11,16,9,0,"0",36,15,12,13,14,54,90
"1642","Sudan","Africa","c",2015,"NF",7,7,2,3,1,4,"0",2,2,1,0,1,4,6
"1643","Suriname","Americas","c",2015,"F",2,2,12,13,8,0,"0",33,15,11,8,10,44,77
"1644","Swaziland","Africa","c",2015,"NF",7,5,0,1,0,0,"0",1,6,2,5,4,17,18
"1645","Sweden","Europe","c",2015,"F",1,1,12,16,12,0,"0",40,15,12,16,16,59,99
"1646","Switzerland","Europe","c",2015,"F",1,1,12,15,12,0,"0",39,15,12,15,15,57,96
"1647","Syria","Middle East","c",2015,"NF",7,7,0,0,0,3,"0",-3,2,0,0,0,2,-1
"1648","Taiwan","Asia","c",2015,"F",1,2,12,15,10,0,"0",37,14,10,14,13,51,88
"1649","Tajikistan","Eurasia","c",2015,"NF",6,6,2,3,2,0,"0",7,5,3,3,4,15,22
"1650","Tanzania","Africa","c",2015,"PF",3,3,9,12,7,0,"0",28,10,7,9,9,35,63
"1651","Thailand","Asia","c",2015,"NF",6,5,1,4,3,0,"0",8,6,4,5,10,25,33
"1652","The Gambia","Africa","c",2015,"NF",6,6,2,5,0,0,"0",7,3,3,1,6,13,20
"1653","Tibet","Asia","t",2015,"NF",7,7,0,0,1,3,"0",-2,0,0,0,3,3,1
"1654","Timor-Leste","Asia","c",2015,"PF",3,3,11,12,6,0,"0",29,12,8,7,9,36,65
"1655","Togo","Africa","c",2015,"PF",4,4,5,8,5,0,"0",18,9,6,7,7,29,47
"1656","Tonga","Asia","c",2015,"F",2,2,11,14,6,0,"0",31,13,8,11,12,44,75
"1657","Transnistria","Eurasia","t",2015,"NF",6,6,3,5,2,0,"0",10,5,2,2,5,14,24
"1658","Trinidad and Tobago","Americas","c",2015,"F",2,2,11,13,9,0,"0",33,15,11,9,13,48,81
"1659","Tunisia","Africa","c",2015,"F",1,3,12,16,8,0,"0",36,13,10,9,11,43,79
"1660","Turkey","Europe","c",2015,"PF",3,4,10,10,6,0,"0",26,8,5,7,9,29,55
"1661","Turkmenistan","Eurasia","c",2015,"NF",7,7,0,1,0,0,"0",1,2,0,0,3,5,6
"1662","Tuvalu","Asia","c",2015,"F",1,1,12,15,10,0,"0",37,16,12,15,14,57,94
"1663","Uganda","Africa","c",2015,"NF",6,5,3,5,3,0,"0",11,9,4,5,7,25,36
"1664","Ukraine","Eurasia","c",2015,"PF",3,3,9,10,6,0,"0",25,11,9,6,11,37,62
"1665","United Arab Emirates","Middle East","c",2015,"NF",6,6,1,2,2,0,"3",8,4,2,3,4,13,21
"1666","United Kingdom","Europe","c",2015,"F",1,1,12,16,12,0,"0",40,15,12,15,15,57,97
"1667","United States","Americas","c",2015,"F",1,1,11,16,10,0,"0",37,15,11,14,15,55,92
"1668","Uruguay","Americas","c",2015,"F",1,1,12,16,12,0,"0",40,16,12,15,15,58,98
"1669","Uzbekistan","Eurasia","c",2015,"NF",7,7,0,0,0,0,"0",0,1,0,0,3,4,4
"1670","Vanuatu","Asia","c",2015,"F",2,2,9,15,8,0,"0",32,15,11,10,11,47,79
"1671","Venezuela","Americas","c",2015,"PF",5,5,5,6,2,0,"0",13,8,3,3,8,22,35
"1672","Vietnam","Asia","c",2015,"NF",7,5,0,1,2,0,"0",3,4,1,4,8,17,20
"1673","West Bank","Middle East","t",2015,"NF",6,5,2,5,2,3,"0",6,9,6,5,5,25,31
"1674","Western Sahara","Africa","t",2015,"NF",7,7,0,0,0,2,"0",-2,3,0,0,4,7,5
"1675","Yemen","Middle East","c",2015,"NF",6,6,3,4,2,0,"0",9,6,3,2,5,16,25
"1676","Zambia","Africa","c",2015,"PF",3,4,8,12,6,0,"0",26,11,7,8,8,34,60
"1677","Zimbabwe","Africa","c",2015,"NF",5,6,3,6,3,0,"0",12,6,3,2,5,16,28
"1678","Abkhazia","Eurasia","t",2014,"PF",4,5,7,7,4,0,"0",18,8,5,4,5,22,40
"1679","Afghanistan","Asia","c",2014,"NF",6,6,3,6,2,0,"0",11,6,4,2,3,15,26
"1680","Albania","Europe","c",2014,"PF",3,3,8,13,6,0,"0",27,13,9,9,9,40,67
"1681","Algeria","Africa","c",2014,"NF",6,5,4,4,3,0,"0",11,6,5,5,7,23,34
"1682","Andorra","Europe","c",2014,"F",1,1,12,15,12,0,"0",39,16,11,15,15,57,96
"1683","Angola","Africa","c",2014,"NF",6,5,4,6,1,0,"0",11,7,4,4,3,18,29
"1684","Antigua and Barbuda","Americas","c",2014,"F",2,2,11,13,7,0,"0",31,14,9,13,13,49,80
"1685","Argentina","Americas","c",2014,"F",2,2,11,14,6,0,"0",31,14,11,11,13,49,80
"1686","Armenia","Eurasia","c",2014,"PF",5,4,5,6,3,0,"0",14,8,6,6,9,29,43
"1687","Australia","Asia","c",2014,"F",1,1,12,15,12,0,"0",39,16,12,15,15,58,97
"1688","Austria","Europe","c",2014,"F",1,1,12,15,11,0,"0",38,16,12,15,15,58,96
"1689","Azerbaijan","Eurasia","c",2014,"NF",6,6,1,3,2,0,"0",6,4,2,4,6,16,22
"1690","Bahamas","Americas","c",2014,"F",1,1,12,16,10,0,"0",38,16,12,15,15,58,96
"1691","Bahrain","Middle East","c",2014,"NF",6,6,3,2,3,2,"0",6,2,1,1,6,10,16
"1692","Bangladesh","Asia","c",2014,"PF",3,4,9,10,5,0,"0",24,8,6,6,9,29,53
"1693","Barbados","Americas","c",2014,"F",1,1,12,16,12,0,"0",40,16,12,16,15,59,99
"1694","Belarus","Eurasia","c",2014,"NF",7,6,0,3,1,0,"0",4,3,1,1,5,10,14
"1695","Belgium","Europe","c",2014,"F",1,1,12,16,12,0,"0",40,15,12,15,15,57,97
"1696","Belize","Americas","c",2014,"F",1,2,12,14,10,0,"0",36,15,11,12,13,51,87
"1697","Benin","Africa","c",2014,"F",2,2,8,16,8,0,"0",32,15,11,12,10,48,80
"1698","Bhutan","Asia","c",2014,"PF",3,4,10,10,9,1,"0",28,9,4,6,8,27,55
"1699","Bolivia","Americas","c",2014,"PF",3,3,11,11,7,0,"0",29,14,9,6,9,38,67
"1700","Bosnia and Herzegovina","Europe","c",2014,"PF",3,3,8,10,6,0,"0",24,10,7,10,10,37,61
"1701","Botswana","Africa","c",2014,"F",3,2,10,10,8,0,"0",28,13,10,12,11,46,74
"1702","Brazil","Americas","c",2014,"F",2,2,11,14,8,0,"0",33,15,10,10,13,48,81
"1703","Brunei","Asia","c",2014,"NF",6,5,0,3,3,0,"1",7,6,3,6,8,23,30
"1704","Bulgaria","Europe","c",2014,"F",2,2,10,14,7,0,"0",31,14,11,11,11,47,78
"1705","Burkina Faso","Africa","c",2014,"PF",5,3,5,8,4,0,"0",17,13,8,7,8,36,53
"1706","Burundi","Africa","c",2014,"PF",5,5,4,6,2,0,"0",12,8,4,4,6,22,34
"1707","Cambodia","Asia","c",2014,"NF",6,5,3,4,3,0,"0",10,9,3,2,6,20,30
"1708","Cameroon","Africa","c",2014,"NF",6,6,3,3,2,0,"0",8,7,3,2,4,16,24
"1709","Canada","Americas","c",2014,"F",1,1,12,16,11,0,"0",39,16,12,15,16,59,98
"1710","Cape Verde","Africa","c",2014,"F",1,1,12,15,10,0,"0",37,15,11,14,13,53,90
"1711","Central African Republic","Africa","c",2014,"NF",7,7,0,1,0,1,"0",0,4,1,0,1,6,6
"1712","Chad","Africa","c",2014,"NF",7,6,3,1,1,0,"0",5,7,4,2,3,16,21
"1713","Chile","Americas","c",2014,"F",1,1,12,15,12,0,"0",39,16,11,14,15,56,95
"1714","China","Asia","c",2014,"NF",7,6,0,1,2,1,"0",2,4,3,2,6,15,17
"1715","Colombia","Americas","c",2014,"PF",3,4,10,11,7,0,"0",28,12,5,7,10,34,62
"1716","Comoros","Africa","c",2014,"PF",3,4,9,11,5,0,"0",25,10,6,8,6,30,55
"1717","Congo (Brazzaville)","Africa","c",2014,"NF",6,5,1,3,3,0,"0",7,8,6,2,7,23,30
"1718","Congo (Kinshasa)","Africa","c",2014,"NF",6,6,3,4,2,0,"0",9,7,3,0,1,11,20
"1719","Costa Rica","Americas","c",2014,"F",1,1,12,15,10,0,"0",37,16,11,13,13,53,90
"1720","Cote d'Ivoire","Africa","c",2014,"PF",5,4,6,7,4,0,"0",17,10,7,5,6,28,45
"1721","Croatia","Europe","c",2014,"F",1,2,12,15,9,0,"0",36,14,12,11,13,50,86
"1722","Cuba","Americas","c",2014,"NF",7,6,0,0,1,0,"0",1,3,0,2,6,11,12
"1723","Cyprus","Europe","c",2014,"F",1,1,11,16,10,0,"0",37,15,11,15,14,55,92
"1724","Czech Republic","Europe","c",2014,"F",1,1,12,15,10,0,"0",37,16,12,14,15,57,94
"1725","Denmark","Europe","c",2014,"F",1,1,12,16,12,0,"0",40,16,12,15,15,58,98
"1726","Djibouti","Africa","c",2014,"NF",6,5,3,3,3,0,"0",9,7,3,4,6,20,29
"1727","Dominica","Americas","c",2014,"F",1,1,12,16,10,0,"0",38,15,12,15,15,57,95
"1728","Dominican Republic","Americas","c",2014,"F",2,3,10,11,9,0,"0",30,15,10,8,10,43,73
"1729","Ecuador","Americas","c",2014,"PF",3,3,7,11,6,0,"0",24,13,7,6,10,36,60
"1730","Egypt","Africa","c",2014,"NF",6,5,1,6,2,0,"0",9,6,4,4,8,22,31
"1731","El Salvador","Americas","c",2014,"F",2,3,12,14,9,0,"0",35,15,8,9,10,42,77
"1732","Equatorial Guinea","Africa","c",2014,"NF",7,7,0,1,0,0,"0",1,4,0,0,3,7,8
"1733","Eritrea","Africa","c",2014,"NF",7,7,0,0,1,0,"0",1,0,0,0,2,2,3
"1734","Estonia","Europe","c",2014,"F",1,1,12,15,12,0,"0",39,16,12,14,14,56,95
"1735","Ethiopia","Africa","c",2014,"NF",6,6,1,2,4,0,"0",7,3,0,3,5,11,18
"1736","Fiji","Asia","c",2014,"PF",6,4,0,5,2,0,"0",7,11,3,6,10,30,37
"1737","Finland","Europe","c",2014,"F",1,1,12,16,12,0,"0",40,16,12,16,16,60,100
"1738","France","Europe","c",2014,"F",1,1,12,15,11,0,"0",38,15,12,15,15,57,95
"1739","Gabon","Africa","c",2014,"NF",6,5,2,4,3,0,"0",9,10,4,6,5,25,34
"1740","Gaza Strip","Middle East","t",2014,"NF",7,6,2,2,1,0,"0",5,4,3,0,3,10,15
"1741","Georgia","Eurasia","c",2014,"PF",3,3,8,10,7,0,"0",25,12,8,8,10,38,63
"1742","Germany","Europe","c",2014,"F",1,1,12,15,12,0,"0",39,15,12,15,15,57,96
"1743","Ghana","Africa","c",2014,"F",1,2,12,15,10,0,"0",37,14,11,12,10,47,84
"1744","Greece","Europe","c",2014,"F",2,2,12,15,8,0,"0",35,14,11,10,13,48,83
"1745","Grenada","Americas","c",2014,"F",1,2,12,16,10,0,"0",38,15,11,12,13,51,89
"1746","Guatemala","Americas","c",2014,"PF",3,4,9,10,5,0,"0",24,12,6,6,8,32,56
"1747","Guinea","Africa","c",2014,"PF",5,5,6,8,3,0,"0",17,9,6,4,5,24,41
"1748","Guinea-Bissau","Africa","c",2014,"NF",6,5,3,5,1,0,"0",9,10,5,3,5,23,32
"1749","Guyana","Americas","c",2014,"F",2,3,11,13,7,0,"0",31,15,10,7,9,41,72
"1750","Haiti","Americas","c",2014,"PF",4,5,4,9,5,0,"0",18,10,5,4,6,25,43
"1751","Honduras","Americas","c",2014,"PF",4,4,7,9,4,0,"0",20,11,6,5,9,31,51
"1752","Hong Kong","Asia","t",2014,"PF",5,2,3,7,6,0,"0",16,14,9,15,13,51,67
"1753","Hungary","Europe","c",2014,"F",1,2,12,15,9,0,"0",36,15,12,11,14,52,88
"1754","Iceland","Europe","c",2014,"F",1,1,12,16,12,0,"0",40,16,12,16,16,60,100
"1755","India","Asia","c",2014,"F",2,3,11,14,9,0,"0",34,13,11,9,10,43,77
"1756","Indian Kashmir","Asia","t",2014,"PF",4,4,8,8,4,0,"0",20,9,6,6,8,29,49
"1757","Indonesia","Asia","c",2014,"PF",2,4,11,13,6,0,"0",30,12,8,5,9,34,64
"1758","Iran","Middle East","c",2014,"NF",6,6,3,2,2,0,"0",7,2,1,3,4,10,17
"1759","Iraq","Middle East","c",2014,"NF",5,6,7,5,1,1,"0",12,5,4,0,4,13,25
"1760","Ireland","Europe","c",2014,"F",1,1,12,16,11,0,"0",39,16,12,15,15,58,97
"1761","Israel","Middle East","c",2014,"F",1,2,12,14,10,0,"0",36,12,11,11,11,45,81
"1762","Italy","Europe","c",2014,"F",1,1,12,15,10,0,"0",37,15,12,12,14,53,90
"1763","Jamaica","Americas","c",2014,"F",2,3,12,13,9,0,"0",34,15,9,6,10,40,74
"1764","Japan","Asia","c",2014,"F",1,1,12,15,10,0,"0",37,14,11,15,13,53,90
"1765","Jordan","Middle East","c",2014,"NF",6,5,2,6,3,0,"0",11,7,3,6,8,24,35
"1766","Kazakhstan","Eurasia","c",2014,"NF",6,5,2,3,1,0,"0",6,4,3,4,8,19,25
"1767","Kenya","Africa","c",2014,"PF",4,4,7,10,5,0,"0",22,11,7,6,7,31,53
"1768","Kiribati","Asia","c",2014,"F",1,1,12,16,8,0,"0",36,15,12,15,13,55,91
"1769","Kosovo","Europe","c",2014,"PF",5,4,6,9,3,1,"0",17,8,6,5,7,26,43
"1770","Kuwait","Middle East","c",2014,"PF",5,5,2,9,5,0,"0",16,6,4,7,6,23,39
"1771","Kyrgyzstan","Eurasia","c",2014,"PF",5,5,6,6,4,2,"0",14,9,5,4,7,25,39
"1772","Laos","Asia","c",2014,"NF",7,6,0,0,1,0,"0",1,4,0,2,5,11,12
"1773","Latvia","Europe","c",2014,"F",2,2,12,14,7,0,"0",33,15,12,12,12,51,84
"1774","Lebanon","Middle East","c",2014,"PF",5,4,4,9,3,0,"0",16,11,7,5,9,32,48
"1775","Lesotho","Africa","c",2014,"F",2,3,10,13,8,0,"0",31,14,7,11,9,41,72
"1776","Liberia","Africa","c",2014,"PF",3,4,9,11,6,0,"0",26,10,8,7,8,33,59
"1777","Libya","Africa","c",2014,"PF",4,5,9,9,3,0,"0",21,8,5,1,6,20,41
"1778","Liechtenstein","Europe","c",2014,"F",1,1,12,15,12,0,"0",39,16,12,15,16,59,98
"1779","Lithuania","Europe","c",2014,"F",1,1,12,16,9,0,"0",37,16,11,13,13,53,90
"1780","Luxembourg","Europe","c",2014,"F",1,1,12,16,11,0,"0",39,16,12,16,16,60,99
"1781","Macedonia","Europe","c",2014,"PF",3,3,8,11,7,0,"0",26,11,8,8,11,38,64
"1782","Madagascar","Africa","c",2014,"PF",5,4,6,8,1,0,"0",15,9,7,5,7,28,43
"1783","Malawi","Africa","c",2014,"PF",3,4,8,11,7,0,"0",26,11,7,9,7,34,60
"1784","Malaysia","Asia","c",2014,"PF",4,4,6,7,6,0,"0",19,8,6,5,9,28,47
"1785","Maldives","Asia","c",2014,"PF",4,4,7,7,5,0,"0",19,7,7,7,8,29,48
"1786","Mali","Africa","c",2014,"PF",5,4,6,7,4,0,"0",17,11,6,6,4,27,44
"1787","Malta","Europe","c",2014,"F",1,1,12,16,11,0,"0",39,16,12,15,15,58,97
"1788","Marshall Islands","Asia","c",2014,"F",1,1,11,15,10,0,"0",36,16,11,15,13,55,91
"1789","Mauritania","Africa","c",2014,"NF",6,5,3,3,5,0,"0",11,10,4,4,5,23,34
"1790","Mauritius","Africa","c",2014,"F",1,2,12,15,11,0,"0",38,15,12,13,12,52,90
"1791","Mexico","Americas","c",2014,"PF",3,3,9,12,7,0,"0",28,13,8,6,10,37,65
"1792","Micronesia","Asia","c",2014,"F",1,1,12,15,10,0,"0",37,16,11,15,14,56,93
"1793","Moldova","Eurasia","c",2014,"PF",3,3,11,12,6,0,"0",29,11,8,7,9,35,64
"1794","Monaco","Europe","c",2014,"F",2,1,10,11,10,0,"0",31,16,12,15,14,57,88
"1795","Mongolia","Asia","c",2014,"F",1,2,11,16,9,0,"0",36,15,11,12,12,50,86
"1796","Montenegro","Europe","c",2014,"F",3,2,9,11,7,0,"0",27,13,10,10,12,45,72
"1797","Morocco","Africa","c",2014,"PF",5,4,5,7,3,0,"0",15,8,6,6,7,27,42
"1798","Mozambique","Africa","c",2014,"PF",4,3,6,10,7,0,"0",23,12,7,7,9,35,58
"1799","Myanmar","Asia","c",2014,"NF",6,5,3,6,3,3,"0",9,7,4,1,5,17,26
"1800","Nagorno-Karabakh","Eurasia","t",2014,"PF",5,5,4,5,3,0,"0",12,6,3,5,5,19,31
"1801","Namibia","Africa","c",2014,"F",2,2,10,11,9,0,"0",30,14,12,11,9,46,76
"1802","Nauru","Asia","c",2014,"F",1,1,12,16,10,0,"0",38,15,11,14,14,54,92
"1803","Nepal","Asia","c",2014,"PF",4,4,8,11,4,0,"0",23,9,6,5,7,27,50
"1804","Netherlands","Europe","c",2014,"F",1,1,12,16,12,0,"0",40,16,12,15,16,59,99
"1805","New Zealand","Asia","c",2014,"F",1,1,12,15,12,0,"0",39,16,12,15,15,58,97
"1806","Nicaragua","Americas","c",2014,"PF",4,3,6,7,6,0,"0",19,12,6,7,10,35,54
"1807","Niger","Africa","c",2014,"PF",3,4,9,10,7,0,"0",26,11,8,5,6,30,56
"1808","Nigeria","Africa","c",2014,"PF",4,4,6,9,5,0,"0",20,9,7,4,6,26,46
"1809","North Korea","Asia","c",2014,"NF",7,7,0,0,0,0,"0",0,0,0,0,3,3,3
"1810","Northern Cyprus","Europe","t",2014,"F",2,2,11,12,9,0,"0",32,14,9,12,12,47,79
"1811","Norway","Europe","c",2014,"F",1,1,12,16,12,0,"0",40,16,12,16,16,60,100
"1812","Oman","Middle East","c",2014,"NF",6,5,2,2,2,0,"3",9,5,3,4,5,17,26
"1813","Pakistan","Asia","c",2014,"PF",4,5,7,9,5,0,"0",21,5,6,4,6,21,42
"1814","Pakistani Kashmir","Asia","t",2014,"NF",6,5,3,4,3,2,"0",8,6,5,4,6,21,29
"1815","Palau","Asia","c",2014,"F",1,1,12,15,10,0,"0",37,16,11,15,13,55,92
"1816","Panama","Americas","c",2014,"F",2,2,12,15,8,0,"0",35,15,11,9,12,47,82
"1817","Papua New Guinea","Asia","c",2014,"PF",3,3,9,10,5,0,"0",24,12,9,7,8,36,60
"1818","Paraguay","Americas","c",2014,"PF",3,3,10,12,4,0,"0",26,12,8,5,10,35,61
"1819","Peru","Americas","c",2014,"F",2,3,10,13,7,0,"0",30,15,8,8,10,41,71
"1820","Philippines","Asia","c",2014,"PF",3,3,9,10,7,0,"0",26,14,8,5,10,37,63
"1821","Poland","Europe","c",2014,"F",1,1,12,16,10,0,"0",38,16,12,13,14,55,93
"1822","Portugal","Europe","c",2014,"F",1,1,12,16,11,0,"0",39,16,12,15,15,58,97
"1823","Puerto Rico","Americas","t",2014,"F",1,2,12,15,10,0,"0",37,16,10,12,14,52,89
"1824","Qatar","Middle East","c",2014,"NF",6,5,2,2,3,0,"3",10,8,2,4,4,18,28
"1825","Romania","Europe","c",2014,"F",2,2,12,14,9,0,"0",35,14,11,12,12,49,84
"1826","Russia","Eurasia","c",2014,"NF",6,5,1,3,3,0,"0",7,6,4,2,7,19,26
"1827","Rwanda","Africa","c",2014,"NF",6,5,2,2,5,0,"0",9,5,2,3,7,17,26
"1828","Samoa","Asia","c",2014,"F",2,2,9,13,10,0,"0",32,14,10,13,12,49,81
"1829","San Marino","Europe","c",2014,"F",1,1,12,16,12,0,"0",40,16,12,16,16,60,100
"1830","Sao Tome and Principe","Africa","c",2014,"F",2,2,11,14,9,0,"0",34,15,10,12,10,47,81
"1831","Saudi Arabia","Middle East","c",2014,"NF",7,7,0,0,1,0,"2",3,3,0,2,2,7,10
"1832","Senegal","Africa","c",2014,"F",2,2,11,13,9,0,"0",33,15,11,10,10,46,79
"1833","Serbia","Europe","c",2014,"F",2,2,9,14,7,0,"0",30,15,10,10,13,48,78
"1834","Seychelles","Africa","c",2014,"PF",3,3,8,10,7,0,"0",25,11,9,11,11,42,67
"1835","Sierra Leone","Africa","c",2014,"PF",3,3,10,12,7,0,"0",29,12,7,9,10,38,67
"1836","Singapore","Asia","c",2014,"PF",4,4,4,8,7,0,"0",19,9,4,7,12,32,51
"1837","Slovakia","Europe","c",2014,"F",1,1,12,15,10,0,"0",37,16,12,12,14,54,91
"1838","Slovenia","Europe","c",2014,"F",1,1,12,15,11,0,"0",38,14,12,14,13,53,91
"1839","Solomon Islands","Asia","c",2014,"PF",4,3,6,10,6,0,"0",22,14,9,8,12,43,65
"1840","Somalia","Africa","c",2014,"NF",7,7,0,0,0,0,"0",0,1,0,0,1,2,2
"1841","Somaliland","Africa","t",2014,"PF",4,5,5,10,6,0,"0",21,7,5,7,6,25,46
"1842","South Africa","Africa","c",2014,"F",2,2,12,13,8,0,"0",33,15,12,10,11,48,81
"1843","South Korea","Asia","c",2014,"F",2,2,11,14,10,0,"0",35,14,11,13,12,50,85
"1844","South Ossetia","Eurasia","t",2014,"NF",7,6,0,0,0,3,"0",-3,4,0,1,3,8,5
"1845","South Sudan","Africa","c",2014,"NF",6,6,4,2,2,0,"0",8,7,3,1,5,16,24
"1846","Spain","Europe","c",2014,"F",1,1,12,16,11,0,"0",39,15,12,15,15,57,96
"1847","Sri Lanka","Asia","c",2014,"PF",5,4,6,6,4,0,"0",16,7,6,5,8,26,42
"1848","St. Kitts and Nevis","Americas","c",2014,"F",1,1,12,16,9,0,"0",37,15,12,13,13,53,90
"1849","St. Lucia","Americas","c",2014,"F",1,1,12,16,11,0,"0",39,15,12,12,14,53,92
"1850","St. Vincent and the Grenadines","Americas","c",2014,"F",1,1,11,16,9,0,"0",36,15,12,12,14,53,89
"1851","Sudan","Africa","c",2014,"NF",7,7,2,3,1,4,"0",2,3,1,0,1,5,7
"1852","Suriname","Americas","c",2014,"F",2,2,12,13,8,0,"0",33,15,11,8,10,44,77
"1853","Swaziland","Africa","c",2014,"NF",7,5,0,1,0,0,"0",1,8,2,5,4,19,20
"1854","Sweden","Europe","c",2014,"F",1,1,12,16,12,0,"0",40,16,12,15,16,59,99
"1855","Switzerland","Europe","c",2014,"F",1,1,12,15,12,0,"0",39,15,12,15,15,57,96
"1856","Syria","Middle East","c",2014,"NF",7,7,0,0,0,2,"0",-2,1,0,0,2,3,1
"1857","Taiwan","Asia","c",2014,"F",1,2,11,15,10,0,"0",36,14,11,14,13,52,88
"1858","Tajikistan","Eurasia","c",2014,"NF",6,6,2,4,2,0,"0",8,5,4,3,4,16,24
"1859","Tanzania","Africa","c",2014,"PF",3,3,9,12,8,0,"0",29,10,7,9,9,35,64
"1860","Thailand","Asia","c",2014,"PF",4,4,8,9,5,0,"0",22,10,6,6,10,32,54
"1861","The Gambia","Africa","c",2014,"NF",6,6,2,5,0,0,"0",7,4,3,1,6,14,21
"1862","Tibet","Asia","t",2014,"NF",7,7,0,0,1,3,"0",-2,0,0,0,3,3,1
"1863","Timor-Leste","Asia","c",2014,"PF",3,4,11,12,6,0,"0",29,12,7,6,9,34,63
"1864","Togo","Africa","c",2014,"PF",4,4,5,8,5,0,"0",18,9,6,7,7,29,47
"1865","Tonga","Asia","c",2014,"F",2,2,11,14,6,0,"0",31,13,8,11,12,44,75
"1866","Transnistria","Eurasia","t",2014,"NF",6,6,3,5,2,0,"0",10,5,2,2,5,14,24
"1867","Trinidad and Tobago","Americas","c",2014,"F",2,2,11,13,9,0,"0",33,15,11,9,13,48,81
"1868","Tunisia","Africa","c",2014,"PF",3,3,9,12,6,0,"0",27,11,9,6,10,36,63
"1869","Turkey","Europe","c",2014,"PF",3,4,11,10,7,0,"0",28,9,6,8,9,32,60
"1870","Turkmenistan","Eurasia","c",2014,"NF",7,7,0,1,0,0,"0",1,2,0,1,3,6,7
"1871","Tuvalu","Asia","c",2014,"F",1,1,12,15,10,0,"0",37,16,12,15,14,57,94
"1872","Uganda","Africa","c",2014,"PF",6,4,3,5,3,0,"0",11,10,4,5,7,26,37
"1873","Ukraine","Eurasia","c",2014,"PF",4,3,8,8,4,0,"0",20,9,8,7,11,35,55
"1874","United Arab Emirates","Middle East","c",2014,"NF",6,6,1,2,2,0,"3",8,4,2,3,4,13,21
"1875","United Kingdom","Europe","c",2014,"F",1,1,12,16,12,0,"0",40,15,12,15,15,57,97
"1876","United States","Americas","c",2014,"F",1,1,11,16,10,0,"0",37,15,11,14,15,55,92
"1877","Uruguay","Americas","c",2014,"F",1,1,12,16,12,0,"0",40,16,12,15,15,58,98
"1878","Uzbekistan","Eurasia","c",2014,"NF",7,7,0,0,0,0,"0",0,1,0,0,3,4,4
"1879","Vanuatu","Asia","c",2014,"F",2,2,9,15,8,0,"0",32,15,11,10,11,47,79
"1880","Venezuela","Americas","c",2014,"PF",5,5,5,7,2,0,"0",14,8,4,4,8,24,38
"1881","Vietnam","Asia","c",2014,"NF",7,5,0,1,2,0,"0",3,4,1,4,8,17,20
"1882","West Bank","Middle East","t",2014,"NF",6,5,2,5,2,2,"0",7,8,6,5,5,24,31
"1883","Western Sahara","Africa","t",2014,"NF",7,7,0,0,0,2,"0",-2,3,0,0,4,7,5
"1884","Yemen","Middle East","c",2014,"NF",6,6,3,4,3,0,"0",10,6,3,2,5,16,26
"1885","Zambia","Africa","c",2014,"PF",3,4,8,10,7,0,"0",25,11,7,8,8,34,59
"1886","Zimbabwe","Africa","c",2014,"NF",5,6,3,6,3,0,"0",12,6,3,2,5,16,28
"1887","Abkhazia","Eurasia","t",2013,"PF",4,5,7,7,4,0,"0",18,8,5,4,5,22,40
"1888","Afghanistan","Asia","c",2013,"NF",6,6,3,6,2,0,"0",11,6,5,2,3,16,27
"1889","Albania","Europe","c",2013,"PF",3,3,8,10,6,0,"0",24,13,8,9,9,39,63
"1890","Algeria","Africa","c",2013,"NF",6,5,4,4,3,0,"0",11,7,5,5,7,24,35
"1891","Andorra","Europe","c",2013,"F",1,1,12,15,12,0,"0",39,16,11,15,15,57,96
"1892","Angola","Africa","c",2013,"NF",6,5,4,6,1,0,"0",11,8,4,4,3,19,30
"1893","Antigua and Barbuda","Americas","c",2013,"F",2,2,11,13,7,0,"0",31,14,9,13,13,49,80
"1894","Argentina","Americas","c",2013,"F",2,2,11,14,6,0,"0",31,14,11,11,13,49,80
"1895","Armenia","Eurasia","c",2013,"PF",5,4,5,5,3,0,"0",13,8,6,6,9,29,42
"1896","Australia","Asia","c",2013,"F",1,1,12,15,12,0,"0",39,16,12,15,15,58,97
"1897","Austria","Europe","c",2013,"F",1,1,12,15,11,0,"0",38,16,12,15,15,58,96
"1898","Azerbaijan","Eurasia","c",2013,"NF",6,5,1,3,2,0,"0",6,4,2,4,7,17,23
"1899","Bahamas","Americas","c",2013,"F",1,1,12,16,10,0,"0",38,16,12,15,15,58,96
"1900","Bahrain","Middle East","c",2013,"NF",6,6,3,2,3,2,"0",6,3,2,1,6,12,18
"1901","Bangladesh","Asia","c",2013,"PF",3,4,9,11,5,0,"0",25,9,7,6,9,31,56
"1902","Barbados","Americas","c",2013,"F",1,1,12,16,12,0,"0",40,16,12,16,15,59,99
"1903","Belarus","Eurasia","c",2013,"NF",7,6,0,3,1,0,"0",4,3,1,1,5,10,14
"1904","Belgium","Europe","c",2013,"F",1,1,12,16,12,0,"0",40,15,12,15,15,57,97
"1905","Belize","Americas","c",2013,"F",1,2,12,14,11,0,"0",37,15,11,12,13,51,88
"1906","Benin","Africa","c",2013,"F",2,2,8,16,8,0,"0",32,15,12,13,10,50,82
"1907","Bhutan","Asia","c",2013,"PF",4,5,8,8,7,1,"0",22,8,3,5,8,24,46
"1908","Bolivia","Americas","c",2013,"PF",3,3,11,11,7,0,"0",29,14,10,7,9,40,69
"1909","Bosnia and Herzegovina","Europe","c",2013,"PF",3,3,8,11,6,0,"0",25,10,7,10,10,37,62
"1910","Botswana","Africa","c",2013,"F",3,2,10,10,8,0,"0",28,13,10,12,11,46,74
"1911","Brazil","Americas","c",2013,"F",2,2,11,14,8,0,"0",33,15,10,10,13,48,81
"1912","Brunei","Asia","c",2013,"NF",6,5,0,3,3,0,"1",7,6,3,6,8,23,30
"1913","Bulgaria","Europe","c",2013,"F",2,2,11,15,8,0,"0",34,14,11,11,11,47,81
"1914","Burkina Faso","Africa","c",2013,"PF",5,3,5,8,4,0,"0",17,13,8,7,8,36,53
"1915","Burundi","Africa","c",2013,"PF",5,5,4,6,2,0,"0",12,8,4,4,6,22,34
"1916","Cambodia","Asia","c",2013,"NF",6,5,3,3,3,0,"0",9,9,3,2,6,20,29
"1917","Cameroon","Africa","c",2013,"NF",6,6,2,3,2,0,"0",7,7,3,2,4,16,23
"1918","Canada","Americas","c",2013,"F",1,1,12,16,12,0,"0",40,16,11,15,16,58,98
"1919","Cape Verde","Africa","c",2013,"F",1,1,12,15,10,0,"0",37,15,11,14,13,53,90
"1920","Central African Republic","Africa","c",2013,"PF",5,5,7,7,2,0,"0",16,8,4,3,4,19,35
"1921","Chad","Africa","c",2013,"NF",7,6,3,1,1,0,"0",5,7,4,2,3,16,21
"1922","Chile","Americas","c",2013,"F",1,1,12,15,12,0,"0",39,16,11,15,15,57,96
"1923","China","Asia","c",2013,"NF",7,6,0,1,2,1,"0",2,4,3,2,6,15,17
"1924","Colombia","Americas","c",2013,"PF",3,4,10,10,7,0,"0",27,12,5,7,10,34,61
"1925","Comoros","Africa","c",2013,"PF",3,4,9,11,5,0,"0",25,10,6,8,6,30,55
"1926","Congo (Brazzaville)","Africa","c",2013,"NF",6,5,1,3,3,0,"0",7,8,6,2,6,22,29
"1927","Congo (Kinshasa)","Africa","c",2013,"NF",6,6,3,4,2,0,"0",9,7,3,0,1,11,20
"1928","Costa Rica","Americas","c",2013,"F",1,1,12,15,11,0,"0",38,16,11,13,13,53,91
"1929","Cote d'Ivoire","Africa","c",2013,"PF",5,5,5,4,4,0,"0",13,8,5,4,4,21,34
"1930","Croatia","Europe","c",2013,"F",1,2,12,15,9,0,"0",36,14,12,11,13,50,86
"1931","Cuba","Americas","c",2013,"NF",7,6,0,0,1,0,"0",1,2,0,2,6,10,11
"1932","Cyprus","Europe","c",2013,"F",1,1,11,16,11,0,"0",38,15,11,15,14,55,93
"1933","Czech Republic","Europe","c",2013,"F",1,1,12,15,11,0,"0",38,16,12,14,15,57,95
"1934","Denmark","Europe","c",2013,"F",1,1,12,16,12,0,"0",40,16,12,15,15,58,98
"1935","Djibouti","Africa","c",2013,"NF",6,5,3,3,3,0,"0",9,7,3,4,6,20,29
"1936","Dominica","Americas","c",2013,"F",1,1,12,16,10,0,"0",38,15,12,15,15,57,95
"1937","Dominican Republic","Americas","c",2013,"F",2,2,10,12,9,0,"0",31,15,10,8,11,44,75
"1938","Ecuador","Americas","c",2013,"PF",3,3,7,11,6,0,"0",24,13,7,6,10,36,60
"1939","Egypt","Africa","c",2013,"PF",5,5,3,10,3,0,"0",16,8,5,4,8,25,41
"1940","El Salvador","Americas","c",2013,"F",2,3,12,14,9,0,"0",35,15,8,9,10,42,77
"1941","Equatorial Guinea","Africa","c",2013,"NF",7,7,0,1,0,0,"0",1,4,0,0,3,7,8
"1942","Eritrea","Africa","c",2013,"NF",7,7,0,0,1,0,"0",1,0,0,0,2,2,3
"1943","Estonia","Europe","c",2013,"F",1,1,12,15,12,0,"0",39,16,12,14,14,56,95
"1944","Ethiopia","Africa","c",2013,"NF",6,6,1,2,4,0,"0",7,3,0,3,5,11,18
"1945","Fiji","Asia","c",2013,"PF",6,4,0,5,2,0,"0",7,11,3,6,10,30,37
"1946","Finland","Europe","c",2013,"F",1,1,12,16,12,0,"0",40,16,12,16,16,60,100
"1947","France","Europe","c",2013,"F",1,1,12,15,11,0,"0",38,15,12,15,15,57,95
"1948","Gabon","Africa","c",2013,"NF",6,5,2,4,3,0,"0",9,10,4,6,5,25,34
"1949","Gaza Strip","Middle East","t",2013,"NF",6,6,5,2,2,0,"0",9,4,3,0,3,10,19
"1950","Georgia","Eurasia","c",2013,"PF",3,3,7,10,7,0,"0",24,12,7,7,10,36,60
"1951","Germany","Europe","c",2013,"F",1,1,12,15,12,0,"0",39,15,12,15,15,57,96
"1952","Ghana","Africa","c",2013,"F",1,2,12,15,10,0,"0",37,14,11,12,10,47,84
"1953","Greece","Europe","c",2013,"F",2,2,12,15,8,0,"0",35,14,11,10,13,48,83
"1954","Grenada","Americas","c",2013,"F",1,2,12,16,10,0,"0",38,15,11,12,13,51,89
"1955","Guatemala","Americas","c",2013,"PF",3,4,9,10,5,0,"0",24,12,7,6,8,33,57
"1956","Guinea","Africa","c",2013,"PF",5,5,5,8,2,0,"0",15,9,6,4,5,24,39
"1957","Guinea-Bissau","Africa","c",2013,"NF",6,5,2,5,0,0,"0",7,10,5,3,5,23,30
"1958","Guyana","Americas","c",2013,"F",2,3,11,13,7,0,"0",31,15,9,7,9,40,71
"1959","Haiti","Americas","c",2013,"PF",4,5,5,9,5,0,"0",19,10,5,4,5,24,43
"1960","Honduras","Americas","c",2013,"PF",4,4,6,8,4,0,"0",18,11,6,7,9,33,51
"1961","Hong Kong","Asia","t",2013,"PF",5,2,3,7,6,0,"0",16,14,9,15,13,51,67
"1962","Hungary","Europe","c",2013,"F",1,2,12,15,9,0,"0",36,15,12,11,14,52,88
"1963","Iceland","Europe","c",2013,"F",1,1,12,16,12,0,"0",40,16,12,16,16,60,100
"1964","India","Asia","c",2013,"F",2,3,11,14,9,0,"0",34,13,11,8,10,42,76
"1965","Indian Kashmir","Asia","t",2013,"PF",4,4,8,8,4,0,"0",20,9,6,6,8,29,49
"1966","Indonesia","Asia","c",2013,"F",2,3,11,13,6,0,"0",30,12,9,5,9,35,65
"1967","Iran","Middle East","c",2013,"NF",6,6,2,2,2,0,"0",6,2,1,3,4,10,16
"1968","Iraq","Middle East","c",2013,"NF",6,6,7,4,1,1,"0",11,5,4,0,4,13,24
"1969","Ireland","Europe","c",2013,"F",1,1,12,16,11,0,"0",39,16,12,15,15,58,97
"1970","Israel","Middle East","c",2013,"F",1,2,12,14,10,0,"0",36,12,11,11,11,45,81
"1971","Italy","Europe","c",2013,"F",2,1,11,15,9,0,"0",35,15,12,12,14,53,88
"1972","Jamaica","Americas","c",2013,"F",2,3,12,13,8,0,"0",33,15,9,6,10,40,73
"1973","Japan","Asia","c",2013,"F",1,2,12,15,10,0,"0",37,13,10,15,13,51,88
"1974","Jordan","Middle East","c",2013,"NF",6,5,2,5,3,0,"0",10,7,3,6,8,24,34
"1975","Kazakhstan","Eurasia","c",2013,"NF",6,5,2,3,1,0,"0",6,5,3,4,8,20,26
"1976","Kenya","Africa","c",2013,"PF",4,4,6,10,5,0,"0",21,13,8,6,7,34,55
"1977","Kiribati","Asia","c",2013,"F",1,1,12,16,8,0,"0",36,15,12,15,13,55,91
"1978","Kosovo","Europe","c",2013,"PF",5,4,6,8,3,1,"0",16,8,6,5,7,26,42
"1979","Kuwait","Middle East","c",2013,"PF",5,5,2,10,5,0,"0",17,7,4,7,6,24,41
"1980","Kyrgyzstan","Eurasia","c",2013,"PF",5,5,6,6,4,2,"0",14,9,5,4,7,25,39
"1981","Laos","Asia","c",2013,"NF",7,6,0,0,0,0,"0",0,4,0,2,5,11,11
"1982","Latvia","Europe","c",2013,"F",2,2,12,14,7,0,"0",33,15,12,12,12,51,84
"1983","Lebanon","Middle East","c",2013,"PF",5,4,5,9,3,0,"0",17,11,7,5,9,32,49
"1984","Lesotho","Africa","c",2013,"F",2,3,10,13,8,0,"0",31,14,7,11,9,41,72
"1985","Liberia","Africa","c",2013,"PF",3,4,9,11,6,0,"0",26,11,8,7,8,34,60
"1986","Libya","Africa","c",2013,"PF",4,5,9,10,3,0,"0",22,8,6,1,6,21,43
"1987","Liechtenstein","Europe","c",2013,"F",1,1,12,15,12,0,"0",39,16,12,15,16,59,98
"1988","Lithuania","Europe","c",2013,"F",1,1,12,16,9,0,"0",37,16,11,13,13,53,90
"1989","Luxembourg","Europe","c",2013,"F",1,1,12,16,12,0,"0",40,16,12,16,16,60,100
"1990","Macedonia","Europe","c",2013,"PF",3,3,8,11,7,0,"0",26,11,8,8,11,38,64
"1991","Madagascar","Africa","c",2013,"PF",6,4,1,5,1,0,"0",7,9,7,5,7,28,35
"1992","Malawi","Africa","c",2013,"PF",3,4,8,11,7,0,"0",26,11,7,9,7,34,60
"1993","Malaysia","Asia","c",2013,"PF",4,4,6,8,6,0,"0",20,9,5,5,9,28,48
"1994","Maldives","Asia","c",2013,"PF",5,4,7,6,4,0,"0",17,7,7,7,8,29,46
"1995","Mali","Africa","c",2013,"NF",7,5,1,3,2,1,"0",5,8,4,3,4,19,24
"1996","Malta","Europe","c",2013,"F",1,1,12,16,11,0,"0",39,16,12,15,15,58,97
"1997","Marshall Islands","Asia","c",2013,"F",1,1,11,15,10,0,"0",36,16,11,15,13,55,91
"1998","Mauritania","Africa","c",2013,"NF",6,5,3,3,5,0,"0",11,10,4,4,5,23,34
"1999","Mauritius","Africa","c",2013,"F",1,2,12,15,11,0,"0",38,15,12,13,12,52,90
"2000","Mexico","Americas","c",2013,"PF",3,3,9,12,7,0,"0",28,13,8,6,10,37,65
"2001","Micronesia","Asia","c",2013,"F",1,1,12,15,10,0,"0",37,16,11,15,14,56,93
"2002","Moldova","Eurasia","c",2013,"PF",3,3,11,12,6,0,"0",29,11,8,8,9,36,65
"2003","Monaco","Europe","c",2013,"F",2,1,10,11,10,0,"0",31,15,12,15,14,56,87
"2004","Mongolia","Asia","c",2013,"F",1,2,11,16,9,0,"0",36,15,11,12,12,50,86
"2005","Montenegro","Europe","c",2013,"F",3,2,9,11,7,0,"0",27,13,10,10,12,45,72
"2006","Morocco","Africa","c",2013,"PF",5,4,5,7,4,0,"0",16,8,6,6,7,27,43
"2007","Mozambique","Africa","c",2013,"PF",4,3,6,10,7,0,"0",23,12,7,8,9,36,59
"2008","Myanmar","Asia","c",2013,"NF",6,5,3,6,3,3,"0",9,7,4,1,5,17,26
"2009","Nagorno-Karabakh","Eurasia","t",2013,"PF",5,5,4,5,3,0,"0",12,6,3,5,5,19,31
"2010","Namibia","Africa","c",2013,"F",2,2,10,11,9,0,"0",30,14,12,11,9,46,76
"2011","Nauru","Asia","c",2013,"F",1,1,12,16,10,0,"0",38,15,11,15,14,55,93
"2012","Nepal","Asia","c",2013,"PF",4,4,5,11,4,0,"0",20,9,6,5,7,27,47
"2013","Netherlands","Europe","c",2013,"F",1,1,12,16,12,0,"0",40,16,12,15,16,59,99
"2014","New Zealand","Asia","c",2013,"F",1,1,12,15,12,0,"0",39,16,12,15,15,58,97
"2015","Nicaragua","Americas","c",2013,"PF",5,4,6,7,4,0,"0",17,12,6,7,9,34,51
"2016","Niger","Africa","c",2013,"PF",3,4,9,10,7,0,"0",26,11,8,5,6,30,56
"2017","Nigeria","Africa","c",2013,"PF",4,4,6,9,5,0,"0",20,9,7,4,6,26,46
"2018","North Korea","Asia","c",2013,"NF",7,7,0,0,0,0,"0",0,0,0,0,3,3,3
"2019","Northern Cyprus","Europe","t",2013,"F",2,2,11,12,9,0,"0",32,13,9,12,12,46,78
"2020","Norway","Europe","c",2013,"F",1,1,12,16,12,0,"0",40,16,12,16,16,60,100
"2021","Oman","Middle East","c",2013,"NF",6,5,2,2,2,0,"3",9,5,3,4,5,17,26
"2022","Pakistan","Asia","c",2013,"PF",4,5,6,9,5,0,"0",20,5,7,4,6,22,42
"2023","Pakistani Kashmir","Asia","t",2013,"NF",6,5,3,4,3,2,"0",8,6,5,4,6,21,29
"2024","Palau","Asia","c",2013,"F",1,1,12,15,10,0,"0",37,16,11,15,13,55,92
"2025","Panama","Americas","c",2013,"F",1,2,12,15,9,0,"0",36,15,10,9,12,46,82
"2026","Papua New Guinea","Asia","c",2013,"PF",4,3,9,10,4,0,"0",23,12,9,7,8,36,59
"2027","Paraguay","Americas","c",2013,"PF",3,3,10,12,5,0,"0",27,11,8,6,10,35,62
"2028","Peru","Americas","c",2013,"F",2,3,10,13,7,0,"0",30,15,8,8,10,41,71
"2029","Philippines","Asia","c",2013,"PF",3,3,9,10,7,0,"0",26,14,8,5,10,37,63
"2030","Poland","Europe","c",2013,"F",1,1,12,16,10,0,"0",38,16,12,13,14,55,93
"2031","Portugal","Europe","c",2013,"F",1,1,12,16,11,0,"0",39,16,12,15,15,58,97
"2032","Puerto Rico","Americas","t",2013,"F",1,2,12,15,10,0,"0",37,16,10,12,14,52,89
"2033","Qatar","Middle East","c",2013,"NF",6,5,2,2,3,0,"3",10,8,2,4,4,18,28
"2034","Romania","Europe","c",2013,"F",2,2,10,14,8,0,"0",32,14,11,12,12,49,81
"2035","Russia","Eurasia","c",2013,"NF",6,5,1,3,3,0,"0",7,6,4,3,7,20,27
"2036","Rwanda","Africa","c",2013,"NF",6,6,2,2,4,0,"0",8,4,2,3,7,16,24
"2037","Samoa","Asia","c",2013,"F",2,2,9,13,10,0,"0",32,14,10,13,12,49,81
"2038","San Marino","Europe","c",2013,"F",1,1,12,16,12,0,"0",40,16,12,16,16,60,100
"2039","Sao Tome and Principe","Africa","c",2013,"F",2,2,11,14,9,0,"0",34,15,10,12,10,47,81
"2040","Saudi Arabia","Middle East","c",2013,"NF",7,7,0,0,1,0,"2",3,3,0,2,2,7,10
"2041","Senegal","Africa","c",2013,"F",2,3,11,13,8,0,"0",32,14,10,10,9,43,75
"2042","Serbia","Europe","c",2013,"F",2,2,9,14,7,0,"0",30,15,10,10,13,48,78
"2043","Seychelles","Africa","c",2013,"PF",3,3,8,10,7,0,"0",25,11,9,11,11,42,67
"2044","Sierra Leone","Africa","c",2013,"F",2,3,10,12,8,0,"0",30,13,8,9,10,40,70
"2045","Singapore","Asia","c",2013,"PF",4,4,4,8,7,0,"0",19,10,4,7,12,33,52
"2046","Slovakia","Europe","c",2013,"F",1,1,12,15,10,0,"0",37,16,12,13,14,55,92
"2047","Slovenia","Europe","c",2013,"F",1,1,12,15,11,0,"0",38,14,12,14,13,53,91
"2048","Solomon Islands","Asia","c",2013,"PF",4,3,6,10,6,0,"0",22,14,9,8,12,43,65
"2049","Somalia","Africa","c",2013,"NF",7,7,0,0,0,0,"0",0,1,0,0,1,2,2
"2050","Somaliland","Africa","t",2013,"PF",4,5,5,10,6,0,"0",21,7,5,7,6,25,46
"2051","South Africa","Africa","c",2013,"F",2,2,12,14,8,0,"0",34,15,11,10,11,47,81
"2052","South Korea","Asia","c",2013,"F",1,2,11,15,10,0,"0",36,14,11,13,12,50,86
"2053","South Ossetia","Eurasia","t",2013,"NF",7,6,0,0,0,3,"0",-3,4,0,1,3,8,5
"2054","South Sudan","Africa","c",2013,"NF",6,5,4,5,2,0,"0",11,8,4,3,5,20,31
"2055","Spain","Europe","c",2013,"F",1,1,12,16,11,0,"0",39,16,12,14,15,57,96
"2056","Sri Lanka","Asia","c",2013,"PF",5,4,6,6,4,0,"0",16,8,6,5,8,27,43
"2057","St. Kitts and Nevis","Americas","c",2013,"F",1,1,12,16,10,0,"0",38,15,12,12,14,53,91
"2058","St. Lucia","Americas","c",2013,"F",1,1,12,16,11,0,"0",39,16,12,12,14,54,93
"2059","St. Vincent and the Grenadines","Americas","c",2013,"F",1,1,11,16,9,0,"0",36,15,11,13,14,53,89
"2060","Sudan","Africa","c",2013,"NF",7,7,2,3,1,4,"0",2,3,1,0,1,5,7
"2061","Suriname","Americas","c",2013,"F",2,2,12,13,8,0,"0",33,15,11,8,10,44,77
"2062","Swaziland","Africa","c",2013,"NF",7,5,0,1,0,0,"0",1,8,3,5,4,20,21
"2063","Sweden","Europe","c",2013,"F",1,1,12,16,12,0,"0",40,16,12,16,16,60,100
"2064","Switzerland","Europe","c",2013,"F",1,1,12,15,12,0,"0",39,15,12,15,15,57,96
"2065","Syria","Middle East","c",2013,"NF",7,7,0,0,1,2,"0",-1,2,0,0,4,6,5
"2066","Taiwan","Asia","c",2013,"F",1,2,11,15,10,0,"0",36,14,11,14,13,52,88
"2067","Tajikistan","Eurasia","c",2013,"NF",6,6,2,4,2,0,"0",8,5,4,3,4,16,24
"2068","Tanzania","Africa","c",2013,"PF",3,3,9,12,7,0,"0",28,11,7,11,9,38,66
"2069","Thailand","Asia","c",2013,"PF",4,4,8,9,5,0,"0",22,9,6,6,10,31,53
"2070","The Gambia","Africa","c",2013,"NF",6,6,2,5,0,0,"0",7,5,4,1,6,16,23
"2071","Tibet","Asia","t",2013,"NF",7,7,0,0,1,3,"0",-2,0,0,0,3,3,1
"2072","Timor-Leste","Asia","c",2013,"PF",3,4,11,12,6,0,"0",29,12,7,6,9,34,63
"2073","Togo","Africa","c",2013,"PF",5,4,4,8,4,0,"0",16,8,6,6,7,27,43
"2074","Tonga","Asia","c",2013,"F",3,2,11,14,4,0,"0",29,13,8,11,12,44,73
"2075","Transnistria","Eurasia","t",2013,"NF",6,6,3,5,2,0,"0",10,6,2,2,5,15,25
"2076","Trinidad and Tobago","Americas","c",2013,"F",2,2,11,13,9,0,"0",33,15,11,9,13,48,81
"2077","Tunisia","Africa","c",2013,"PF",3,4,9,12,5,0,"0",26,10,8,6,9,33,59
"2078","Turkey","Europe","c",2013,"PF",3,4,11,10,7,0,"0",28,9,7,7,10,33,61
"2079","Turkmenistan","Eurasia","c",2013,"NF",7,7,0,1,0,0,"0",1,2,0,1,3,6,7
"2080","Tuvalu","Asia","c",2013,"F",1,1,12,15,10,0,"0",37,16,12,15,14,57,94
"2081","Uganda","Africa","c",2013,"PF",5,4,3,6,3,0,"0",12,11,4,6,7,28,40
"2082","Ukraine","Eurasia","c",2013,"PF",4,3,8,9,4,0,"0",21,10,8,7,11,36,57
"2083","United Arab Emirates","Middle East","c",2013,"NF",6,6,1,2,2,0,"3",8,4,2,4,4,14,22
"2084","United Kingdom","Europe","c",2013,"F",1,1,12,16,12,0,"0",40,15,12,15,15,57,97
"2085","United States","Americas","c",2013,"F",1,1,11,16,10,0,"0",37,16,11,14,15,56,93
"2086","Uruguay","Americas","c",2013,"F",1,1,12,16,11,0,"0",39,16,12,15,15,58,97
"2087","Uzbekistan","Eurasia","c",2013,"NF",7,7,0,0,0,0,"0",0,1,0,0,3,4,4
"2088","Vanuatu","Asia","c",2013,"F",2,2,9,15,8,0,"0",32,15,11,10,11,47,79
"2089","Venezuela","Americas","c",2013,"PF",5,5,5,8,2,0,"0",15,9,4,4,7,24,39
"2090","Vietnam","Asia","c",2013,"NF",7,5,0,1,1,0,"0",2,4,1,4,8,17,19
"2091","West Bank","Middle East","t",2013,"NF",6,5,2,5,2,3,"0",6,8,6,5,5,24,30
"2092","Western Sahara","Africa","t",2013,"NF",7,7,0,0,0,2,"0",-2,3,0,0,4,7,5
"2093","Yemen","Middle East","c",2013,"NF",6,6,3,4,2,0,"0",9,6,3,2,5,16,25
"2094","Zambia","Africa","c",2013,"PF",3,4,9,12,7,0,"0",28,11,7,8,8,34,62
"2095","Zimbabwe","Africa","c",2013,"NF",6,6,3,5,3,0,"0",11,6,3,1,4,14,25
"2096","Abkhazia","Eurasia","t",2012,"PF",5,5,6,7,4,0,"0",17,8,5,4,5,22,39
"2097","Afghanistan","Asia","c",2012,"NF",6,6,3,6,1,0,"0",10,5,4,1,3,13,23
"2098","Albania","Europe","c",2012,"PF",3,3,8,10,6,0,"0",24,13,8,9,9,39,63
"2099","Algeria","Africa","c",2012,"NF",6,5,4,4,3,0,"0",11,7,5,5,7,24,35
"2100","Andorra","Europe","c",2012,"F",1,1,12,15,12,0,"0",39,16,11,15,15,57,96
"2101","Angola","Africa","c",2012,"NF",6,5,3,6,1,0,"0",10,8,4,4,3,19,29
"2102","Antigua and Barbuda","Americas","c",2012,"F",3,2,11,12,6,0,"0",29,13,9,13,13,48,77
"2103","Argentina","Americas","c",2012,"F",2,2,11,15,6,0,"0",32,14,11,11,13,49,81
"2104","Armenia","Eurasia","c",2012,"PF",6,4,4,4,3,0,"0",11,8,6,6,9,29,40
"2105","Australia","Asia","c",2012,"F",1,1,12,15,12,0,"0",39,16,12,14,15,57,96
"2106","Austria","Europe","c",2012,"F",1,1,12,15,12,0,"0",39,16,12,15,15,58,97
"2107","Azerbaijan","Eurasia","c",2012,"NF",6,5,1,3,2,0,"0",6,4,2,4,7,17,23
"2108","Bahamas","Americas","c",2012,"F",1,1,12,16,10,0,"0",38,16,12,15,15,58,96
"2109","Bahrain","Middle East","c",2012,"NF",6,6,3,3,4,2,"0",8,3,2,1,6,12,20
"2110","Bangladesh","Asia","c",2012,"PF",3,4,9,11,5,0,"0",25,9,8,7,9,33,58
"2111","Barbados","Americas","c",2012,"F",1,1,12,16,12,0,"0",40,16,12,16,15,59,99
"2112","Belarus","Eurasia","c",2012,"NF",7,6,0,3,1,0,"0",4,3,1,1,5,10,14
"2113","Belgium","Europe","c",2012,"F",1,1,12,16,12,0,"0",40,16,12,15,15,58,98
"2114","Belize","Americas","c",2012,"F",1,2,12,14,11,0,"0",37,15,11,12,13,51,88
"2115","Benin","Africa","c",2012,"F",2,2,8,16,8,0,"0",32,15,11,13,10,49,81
"2116","Bhutan","Asia","c",2012,"PF",4,5,7,7,6,1,"0",19,8,3,5,8,24,43
"2117","Bolivia","Americas","c",2012,"PF",3,3,11,11,6,0,"0",28,14,9,6,9,38,66
"2118","Bosnia and Herzegovina","Europe","c",2012,"PF",4,3,8,10,5,0,"0",23,10,7,10,10,37,60
"2119","Botswana","Africa","c",2012,"F",3,2,10,11,8,0,"0",29,13,10,12,11,46,75
"2120","Brazil","Americas","c",2012,"F",2,2,11,14,8,0,"0",33,15,10,10,12,47,80
"2121","Brunei","Asia","c",2012,"NF",6,5,0,3,3,0,"1",7,6,3,6,8,23,30
"2122","Bulgaria","Europe","c",2012,"F",2,2,11,15,8,0,"0",34,14,11,11,11,47,81
"2123","Burkina Faso","Africa","c",2012,"PF",5,3,5,7,4,0,"0",16,13,8,6,8,35,51
"2124","Burundi","Africa","c",2012,"PF",5,5,4,6,3,0,"0",13,8,4,4,6,22,35
"2125","Cambodia","Asia","c",2012,"NF",6,5,3,3,3,0,"0",9,9,4,2,6,21,30
"2126","Cameroon","Africa","c",2012,"NF",6,6,2,3,2,0,"0",7,7,3,2,4,16,23
"2127","Canada","Americas","c",2012,"F",1,1,12,16,12,0,"0",40,16,12,15,16,59,99
"2128","Cape Verde","Africa","c",2012,"F",1,1,12,15,10,0,"0",37,15,11,14,13,53,90
"2129","Central African Republic","Africa","c",2012,"PF",5,5,7,7,3,0,"0",17,10,5,3,4,22,39
"2130","Chad","Africa","c",2012,"NF",7,6,3,1,1,0,"0",5,7,4,2,3,16,21
"2131","Chile","Americas","c",2012,"F",1,1,12,15,12,0,"0",39,16,12,15,15,58,97
"2132","China","Asia","c",2012,"NF",7,6,0,1,2,1,"0",2,3,3,2,6,14,16
"2133","Colombia","Americas","c",2012,"PF",3,4,10,10,7,0,"0",27,12,5,7,10,34,61
"2134","Comoros","Africa","c",2012,"PF",3,4,9,11,5,0,"0",25,10,6,8,6,30,55
"2135","Congo (Brazzaville)","Africa","c",2012,"NF",6,5,1,3,3,0,"0",7,8,6,2,6,22,29
"2136","Congo (Kinshasa)","Africa","c",2012,"NF",6,6,3,4,2,0,"0",9,7,3,0,1,11,20
"2137","Costa Rica","Americas","c",2012,"F",1,1,12,15,11,0,"0",38,16,11,13,13,53,91
"2138","Cote d'Ivoire","Africa","c",2012,"NF",6,6,5,4,2,0,"0",11,4,5,0,4,13,24
"2139","Croatia","Europe","c",2012,"F",1,2,12,15,9,0,"0",36,14,12,11,13,50,86
"2140","Cuba","Americas","c",2012,"NF",7,6,0,0,1,0,"0",1,3,1,2,4,10,11
"2141","Cyprus","Europe","c",2012,"F",1,1,11,16,11,0,"0",38,15,11,15,14,55,93
"2142","Czech Republic","Europe","c",2012,"F",1,1,12,15,11,0,"0",38,16,12,14,15,57,95
"2143","Denmark","Europe","c",2012,"F",1,1,12,16,12,0,"0",40,16,12,15,15,58,98
"2144","Djibouti","Africa","c",2012,"NF",6,5,3,3,3,0,"0",9,7,3,4,6,20,29
"2145","Dominica","Americas","c",2012,"F",1,1,12,16,10,0,"0",38,16,12,15,15,58,96
"2146","Dominican Republic","Americas","c",2012,"F",2,2,10,12,9,0,"0",31,15,10,8,11,44,75
"2147","Ecuador","Americas","c",2012,"PF",3,3,8,13,6,0,"0",27,13,7,6,10,36,63
"2148","Egypt","Africa","c",2012,"NF",6,5,2,7,2,0,"0",11,8,5,4,7,24,35
"2149","El Salvador","Americas","c",2012,"F",2,3,12,14,9,0,"0",35,15,8,8,10,41,76
"2150","Equatorial Guinea","Africa","c",2012,"NF",7,7,0,1,0,0,"0",1,4,0,0,3,7,8
"2151","Eritrea","Africa","c",2012,"NF",7,7,0,1,1,0,"0",2,1,0,0,3,4,6
"2152","Estonia","Europe","c",2012,"F",1,1,12,15,12,0,"0",39,16,12,14,14,56,95
"2153","Ethiopia","Africa","c",2012,"NF",6,6,1,2,4,0,"0",7,4,0,3,5,12,19
"2154","Fiji","Asia","c",2012,"PF",6,4,0,5,2,0,"0",7,10,2,6,10,28,35
"2155","Finland","Europe","c",2012,"F",1,1,12,16,12,0,"0",40,16,12,16,16,60,100
"2156","France","Europe","c",2012,"F",1,1,12,15,11,0,"0",38,15,12,15,15,57,95
"2157","Gabon","Africa","c",2012,"NF",6,5,2,4,3,0,"0",9,10,4,6,5,25,34
"2158","Gaza Strip","Middle East","t",2012,"NF",6,6,5,2,2,0,"0",9,4,3,0,3,10,19
"2159","Georgia","Eurasia","c",2012,"PF",4,3,6,9,7,0,"0",22,12,7,7,10,36,58
"2160","Germany","Europe","c",2012,"F",1,1,12,15,12,0,"0",39,15,12,15,15,57,96
"2161","Ghana","Africa","c",2012,"F",1,2,12,15,10,0,"0",37,14,11,12,10,47,84
"2162","Greece","Europe","c",2012,"F",2,2,12,15,8,0,"0",35,14,12,11,13,50,85
"2163","Grenada","Americas","c",2012,"F",1,2,12,16,10,0,"0",38,15,10,12,14,51,89
"2164","Guatemala","Americas","c",2012,"PF",3,4,9,10,5,0,"0",24,12,8,6,8,34,58
"2165","Guinea","Africa","c",2012,"PF",5,5,5,8,1,0,"0",14,7,5,4,4,20,34
"2166","Guinea-Bissau","Africa","c",2012,"PF",4,4,9,7,2,0,"0",18,10,8,4,5,27,45
"2167","Guyana","Americas","c",2012,"F",2,3,11,13,7,0,"0",31,15,10,7,9,41,72
"2168","Haiti","Americas","c",2012,"PF",4,5,5,10,5,0,"0",20,10,6,4,5,25,45
"2169","Honduras","Americas","c",2012,"PF",4,4,6,8,5,0,"0",19,11,6,7,9,33,52
"2170","Hong Kong","Asia","t",2012,"PF",5,2,3,7,6,0,"0",16,14,9,15,13,51,67
"2171","Hungary","Europe","c",2012,"F",1,2,12,15,9,0,"0",36,15,12,11,14,52,88
"2172","Iceland","Europe","c",2012,"F",1,1,12,16,12,0,"0",40,16,12,16,15,59,99
"2173","India","Asia","c",2012,"F",2,3,11,14,9,0,"0",34,13,11,9,10,43,77
"2174","Indian Kashmir","Asia","t",2012,"PF",4,4,8,8,4,0,"0",20,9,6,5,8,28,48
"2175","Indonesia","Asia","c",2012,"F",2,3,11,13,6,0,"0",30,12,9,5,9,35,65
"2176","Iran","Middle East","c",2012,"NF",6,6,2,2,2,0,"0",6,2,1,3,4,10,16
"2177","Iraq","Middle East","c",2012,"NF",5,6,7,5,1,1,"0",12,5,4,0,4,13,25
"2178","Ireland","Europe","c",2012,"F",1,1,12,16,11,0,"0",39,16,12,15,15,58,97
"2179","Israel","Middle East","c",2012,"F",1,2,12,14,10,0,"0",36,12,11,11,11,45,81
"2180","Italy","Europe","c",2012,"F",1,1,11,15,10,0,"0",36,15,12,12,14,53,89
"2181","Jamaica","Americas","c",2012,"F",2,3,12,13,8,0,"0",33,15,9,6,10,40,73
"2182","Japan","Asia","c",2012,"F",1,2,12,15,10,0,"0",37,13,10,15,13,51,88
"2183","Jordan","Middle East","c",2012,"NF",6,5,2,5,3,0,"0",10,7,4,6,8,25,35
"2184","Kazakhstan","Eurasia","c",2012,"NF",6,5,2,3,1,0,"0",6,6,3,4,8,21,27
"2185","Kenya","Africa","c",2012,"PF",4,3,6,10,5,0,"0",21,14,8,7,7,36,57
"2186","Kiribati","Asia","c",2012,"F",1,1,12,16,8,0,"0",36,15,12,15,13,55,91
"2187","Kosovo","Europe","c",2012,"PF",5,4,6,7,3,1,"0",15,8,6,5,7,26,41
"2188","Kuwait","Middle East","c",2012,"PF",4,5,4,10,5,0,"0",19,7,5,7,6,25,44
"2189","Kyrgyzstan","Eurasia","c",2012,"PF",5,5,6,7,5,2,"0",16,9,5,4,7,25,41
"2190","Laos","Asia","c",2012,"NF",7,6,0,0,0,0,"0",0,4,1,2,5,12,12
"2191","Latvia","Europe","c",2012,"F",2,2,12,14,7,0,"0",33,15,12,12,12,51,84
"2192","Lebanon","Middle East","c",2012,"PF",5,4,5,9,3,0,"0",17,12,7,6,9,34,51
"2193","Lesotho","Africa","c",2012,"PF",3,3,9,11,8,0,"0",28,14,7,11,9,41,69
"2194","Liberia","Africa","c",2012,"PF",3,4,9,11,6,0,"0",26,11,8,7,8,34,60
"2195","Libya","Africa","c",2012,"NF",7,6,0,3,0,0,"0",3,5,3,0,6,14,17
"2196","Liechtenstein","Europe","c",2012,"F",1,1,12,15,12,0,"0",39,16,12,15,16,59,98
"2197","Lithuania","Europe","c",2012,"F",1,1,12,16,9,0,"0",37,16,11,13,13,53,90
"2198","Luxembourg","Europe","c",2012,"F",1,1,12,16,12,0,"0",40,16,12,16,16,60,100
"2199","Macedonia","Europe","c",2012,"PF",3,3,8,11,7,0,"0",26,11,8,9,11,39,65
"2200","Madagascar","Africa","c",2012,"PF",6,4,1,5,1,0,"0",7,10,7,6,9,32,39
"2201","Malawi","Africa","c",2012,"PF",3,4,7,11,7,0,"0",25,10,6,9,7,32,57
"2202","Malaysia","Asia","c",2012,"PF",4,4,6,8,6,0,"0",20,9,5,6,9,29,49
"2203","Maldives","Asia","c",2012,"PF",3,4,9,9,6,0,"0",24,8,8,8,8,32,56
"2204","Mali","Africa","c",2012,"F",2,3,9,13,9,0,"0",31,16,10,8,7,41,72
"2205","Malta","Europe","c",2012,"F",1,1,12,16,11,0,"0",39,16,12,15,15,58,97
"2206","Marshall Islands","Asia","c",2012,"F",1,1,11,15,10,0,"0",36,16,11,15,13,55,91
"2207","Mauritania","Africa","c",2012,"NF",6,5,3,3,5,0,"0",11,9,4,4,5,22,33
"2208","Mauritius","Africa","c",2012,"F",1,2,12,15,11,0,"0",38,15,12,13,12,52,90
"2209","Mexico","Americas","c",2012,"PF",3,3,10,12,7,0,"0",29,13,8,6,10,37,66
"2210","Micronesia","Asia","c",2012,"F",1,1,12,15,10,0,"0",37,16,11,15,14,56,93
"2211","Moldova","Eurasia","c",2012,"PF",3,3,11,12,5,0,"0",28,12,8,8,9,37,65
"2212","Monaco","Europe","c",2012,"F",2,1,10,11,10,0,"0",31,15,12,15,14,56,87
"2213","Mongolia","Asia","c",2012,"F",2,2,10,15,10,0,"0",35,15,11,12,12,50,85
"2214","Montenegro","Europe","c",2012,"F",3,2,9,11,7,0,"0",27,13,10,10,12,45,72
"2215","Morocco","Africa","c",2012,"PF",5,4,4,7,4,0,"0",15,8,6,6,8,28,43
"2216","Mozambique","Africa","c",2012,"PF",4,3,6,10,7,0,"0",23,12,7,8,9,36,59
"2217","Myanmar","Asia","c",2012,"NF",7,6,1,4,2,3,"0",4,5,2,0,3,10,14
"2218","Nagorno-Karabakh","Eurasia","t",2012,"NF",6,5,4,3,3,0,"0",10,6,3,5,5,19,29
"2219","Namibia","Africa","c",2012,"F",2,2,10,11,9,0,"0",30,14,12,11,9,46,76
"2220","Nauru","Asia","c",2012,"F",1,1,12,16,10,0,"0",38,15,11,15,14,55,93
"2221","Nepal","Asia","c",2012,"PF",4,4,6,11,4,0,"0",21,9,6,5,7,27,48
"2222","Netherlands","Europe","c",2012,"F",1,1,12,16,12,0,"0",40,16,12,15,16,59,99
"2223","New Zealand","Asia","c",2012,"F",1,1,12,15,12,0,"0",39,16,12,15,15,58,97
"2224","Nicaragua","Americas","c",2012,"PF",5,4,6,7,4,0,"0",17,12,6,7,9,34,51
"2225","Niger","Africa","c",2012,"PF",3,4,9,10,7,0,"0",26,11,8,5,6,30,56
"2226","Nigeria","Africa","c",2012,"PF",4,4,6,9,6,0,"0",21,9,8,4,7,28,49
"2227","North Korea","Asia","c",2012,"NF",7,7,0,0,0,0,"0",0,0,0,0,2,2,2
"2228","Northern Cyprus","Europe","t",2012,"F",2,2,11,14,9,0,"0",34,14,9,12,12,47,81
"2229","Norway","Europe","c",2012,"F",1,1,12,16,12,0,"0",40,16,12,16,16,60,100
"2230","Oman","Middle East","c",2012,"NF",6,5,2,2,2,0,"3",9,6,3,4,5,18,27
"2231","Pakistan","Asia","c",2012,"PF",4,5,6,9,5,0,"0",20,6,7,4,6,23,43
"2232","Pakistani Kashmir","Asia","t",2012,"NF",6,5,3,4,3,2,"0",8,6,5,4,6,21,29
"2233","Palau","Asia","c",2012,"F",1,1,12,15,10,0,"0",37,16,11,15,13,55,92
"2234","Panama","Americas","c",2012,"F",1,2,12,15,9,0,"0",36,15,11,9,12,47,83
"2235","Papua New Guinea","Asia","c",2012,"PF",4,3,9,10,4,0,"0",23,12,9,7,8,36,59
"2236","Paraguay","Americas","c",2012,"PF",3,3,11,12,5,0,"0",28,12,8,6,10,36,64
"2237","Peru","Americas","c",2012,"F",2,3,10,13,7,0,"0",30,15,8,8,10,41,71
"2238","Philippines","Asia","c",2012,"PF",3,3,9,10,7,0,"0",26,14,8,4,10,36,62
"2239","Poland","Europe","c",2012,"F",1,1,12,16,10,0,"0",38,16,12,13,14,55,93
"2240","Portugal","Europe","c",2012,"F",1,1,12,16,11,0,"0",39,16,12,15,15,58,97
"2241","Puerto Rico","Americas","t",2012,"F",1,2,12,15,10,0,"0",37,16,10,12,14,52,89
"2242","Qatar","Middle East","c",2012,"NF",6,5,2,2,3,0,"3",10,8,2,4,4,18,28
"2243","Romania","Europe","c",2012,"F",2,2,12,14,8,0,"0",34,14,11,12,12,49,83
"2244","Russia","Eurasia","c",2012,"NF",6,5,1,3,3,0,"0",7,6,5,3,7,21,28
"2245","Rwanda","Africa","c",2012,"NF",6,5,2,2,4,0,"0",8,4,2,4,7,17,25
"2246","Samoa","Asia","c",2012,"F",2,2,9,13,10,0,"0",32,14,10,13,12,49,81
"2247","San Marino","Europe","c",2012,"F",1,1,12,16,12,0,"0",40,16,12,16,16,60,100
"2248","Sao Tome and Principe","Africa","c",2012,"F",2,2,11,14,8,0,"0",33,15,10,12,10,47,80
"2249","Saudi Arabia","Middle East","c",2012,"NF",7,7,0,0,1,0,"2",3,3,0,2,2,7,10
"2250","Senegal","Africa","c",2012,"PF",3,3,9,12,7,0,"0",28,14,10,10,9,43,71
"2251","Serbia","Europe","c",2012,"F",2,2,9,14,7,0,"0",30,15,10,10,13,48,78
"2252","Seychelles","Africa","c",2012,"PF",3,3,8,10,7,0,"0",25,11,9,11,11,42,67
"2253","Sierra Leone","Africa","c",2012,"PF",3,3,10,11,7,0,"0",28,13,8,8,10,39,67
"2254","Singapore","Asia","c",2012,"PF",4,4,4,8,7,0,"0",19,10,4,7,12,33,52
"2255","Slovakia","Europe","c",2012,"F",1,1,12,15,10,0,"0",37,16,12,13,14,55,92
"2256","Slovenia","Europe","c",2012,"F",1,1,12,15,11,0,"0",38,14,12,14,13,53,91
"2257","Solomon Islands","Asia","c",2012,"PF",4,3,6,10,6,0,"0",22,13,9,8,12,42,64
"2258","Somalia","Africa","c",2012,"NF",7,7,0,0,0,0,"0",0,1,0,0,0,1,1
"2259","Somaliland","Africa","t",2012,"PF",4,5,5,10,6,0,"0",21,7,5,7,6,25,46
"2260","South Africa","Africa","c",2012,"F",2,2,12,14,8,0,"0",34,15,12,10,11,48,82
"2261","South Korea","Asia","c",2012,"F",1,2,11,15,10,0,"0",36,14,11,13,12,50,86
"2262","South Ossetia","Eurasia","t",2012,"NF",7,6,0,0,0,3,"0",-3,4,0,1,3,8,5
"2263","South Sudan","Africa","c",2012,"NF",6,5,3,5,3,0,"0",11,8,6,3,5,22,33
"2264","Spain","Europe","c",2012,"F",1,1,12,16,12,0,"0",40,16,12,14,15,57,97
"2265","Sri Lanka","Asia","c",2012,"PF",5,4,6,6,5,0,"0",17,8,6,6,8,28,45
"2266","St. Kitts and Nevis","Americas","c",2012,"F",1,1,12,16,11,0,"0",39,15,12,12,14,53,92
"2267","St. Lucia","Americas","c",2012,"F",1,1,12,16,11,0,"0",39,15,12,12,14,53,92
"2268","St. Vincent and the Grenadines","Americas","c",2012,"F",1,1,11,16,9,0,"0",36,15,11,13,14,53,89
"2269","Sudan","Africa","c",2012,"NF",7,7,2,3,1,4,"0",2,3,1,0,0,4,6
"2270","Suriname","Americas","c",2012,"F",2,2,12,13,8,0,"0",33,15,11,9,10,45,78
"2271","Swaziland","Africa","c",2012,"NF",7,5,0,1,0,0,"0",1,8,3,5,4,20,21
"2272","Sweden","Europe","c",2012,"F",1,1,12,16,12,0,"0",40,16,12,16,16,60,100
"2273","Switzerland","Europe","c",2012,"F",1,1,12,15,12,0,"0",39,15,12,15,15,57,96
"2274","Syria","Middle East","c",2012,"NF",7,7,0,0,1,1,"0",0,2,0,0,4,6,6
"2275","Taiwan","Asia","c",2012,"F",1,2,11,15,10,0,"0",36,14,11,14,13,52,88
"2276","Tajikistan","Eurasia","c",2012,"NF",6,5,2,4,2,0,"0",8,6,4,4,4,18,26
"2277","Tanzania","Africa","c",2012,"PF",3,3,9,12,7,0,"0",28,11,7,10,8,36,64
"2278","Thailand","Asia","c",2012,"PF",4,4,8,8,5,0,"0",21,9,6,6,10,31,52
"2279","The Gambia","Africa","c",2012,"NF",6,5,2,5,0,0,"0",7,5,4,2,6,17,24
"2280","Tibet","Asia","t",2012,"NF",7,7,0,0,1,3,"0",-2,0,0,0,3,3,1
"2281","Timor-Leste","Asia","c",2012,"PF",3,4,11,11,6,0,"0",28,12,7,6,9,34,62
"2282","Togo","Africa","c",2012,"PF",5,4,5,8,4,0,"0",17,8,6,6,7,27,44
"2283","Tonga","Asia","c",2012,"PF",3,3,11,14,4,0,"0",29,12,7,11,12,42,71
"2284","Transnistria","Eurasia","t",2012,"NF",6,6,3,5,1,0,"0",9,6,2,2,5,15,24
"2285","Trinidad and Tobago","Americas","c",2012,"F",2,2,11,13,9,0,"0",33,15,11,9,13,48,81
"2286","Tunisia","Africa","c",2012,"PF",3,4,9,12,4,0,"0",25,10,8,6,9,33,58
"2287","Turkey","Europe","c",2012,"PF",3,3,11,10,7,0,"0",28,10,7,8,10,35,63
"2288","Turkmenistan","Eurasia","c",2012,"NF",7,7,0,1,0,0,"0",1,2,0,1,3,6,7
"2289","Tuvalu","Asia","c",2012,"F",1,1,12,15,10,0,"0",37,16,12,15,14,57,94
"2290","Uganda","Africa","c",2012,"PF",5,4,3,7,3,0,"0",13,11,5,6,7,29,42
"2291","Ukraine","Eurasia","c",2012,"PF",4,3,9,10,4,0,"0",23,10,8,8,11,37,60
"2292","United Arab Emirates","Middle East","c",2012,"NF",6,6,1,2,2,0,"3",8,6,2,4,4,16,24
"2293","United Kingdom","Europe","c",2012,"F",1,1,12,16,12,0,"0",40,15,12,14,15,56,96
"2294","United States","Americas","c",2012,"F",1,1,11,16,11,0,"0",38,16,10,14,15,55,93
"2295","Uruguay","Americas","c",2012,"F",1,1,12,16,11,0,"0",39,16,12,15,15,58,97
"2296","Uzbekistan","Eurasia","c",2012,"NF",7,7,0,0,0,0,"0",0,1,0,0,3,4,4
"2297","Vanuatu","Asia","c",2012,"F",2,2,9,15,8,0,"0",32,16,11,10,11,48,80
"2298","Venezuela","Americas","c",2012,"PF",5,5,6,8,3,0,"0",17,9,4,4,7,24,41
"2299","Vietnam","Asia","c",2012,"NF",7,5,0,1,1,0,"0",2,4,1,4,8,17,19
"2300","West Bank","Middle East","t",2012,"NF",6,5,2,5,2,2,"0",7,8,6,5,5,24,31
"2301","Western Sahara","Africa","t",2012,"NF",7,7,0,0,0,2,"0",-2,3,0,0,4,7,5
"2302","Yemen","Middle East","c",2012,"NF",6,6,3,4,1,0,"0",8,6,2,2,5,15,23
"2303","Zambia","Africa","c",2012,"PF",3,4,9,13,7,0,"0",29,11,7,8,8,34,63
"2304","Zimbabwe","Africa","c",2012,"NF",6,6,2,4,2,0,"0",8,4,3,1,4,12,20
"2305","Abkhazia","Eurasia","t",2011,"PF",5,5,5,6,4,0,"0",15,8,5,4,5,22,37
"2306","Afghanistan","Asia","c",2011,"NF",6,6,3,6,1,0,"0",10,5,4,2,4,15,25
"2307","Albania","Europe","c",2011,"PF",3,3,8,11,7,0,"0",26,13,9,9,9,40,66
"2308","Algeria","Africa","c",2011,"NF",6,5,4,4,3,0,"0",11,7,6,5,7,25,36
"2309","Andorra","Europe","c",2011,"F",1,1,12,15,12,0,"0",39,16,11,15,15,57,96
"2310","Angola","Africa","c",2011,"NF",6,5,3,6,1,0,"0",10,8,6,4,3,21,31
"2311","Antigua and Barbuda","Americas","c",2011,"F",3,2,11,12,6,0,"0",29,13,9,13,13,48,77
"2312","Argentina","Americas","c",2011,"F",2,2,11,15,6,0,"0",32,14,11,10,13,48,80
"2313","Armenia","Eurasia","c",2011,"PF",6,4,4,4,3,0,"0",11,8,5,6,9,28,39
"2314","Australia","Asia","c",2011,"F",1,1,12,15,12,0,"0",39,16,12,14,15,57,96
"2315","Austria","Europe","c",2011,"F",1,1,12,15,12,0,"0",39,16,12,15,15,58,97
"2316","Azerbaijan","Eurasia","c",2011,"NF",6,5,1,3,3,0,"0",7,6,3,4,8,21,28
"2317","Bahamas","Americas","c",2011,"F",1,1,12,16,10,0,"0",38,16,12,15,15,58,96
"2318","Bahrain","Middle East","c",2011,"NF",6,5,3,6,4,2,"0",11,8,3,1,7,19,30
"2319","Bangladesh","Asia","c",2011,"PF",3,4,9,11,6,0,"0",26,9,9,7,9,34,60
"2320","Barbados","Americas","c",2011,"F",1,1,12,16,12,0,"0",40,16,12,16,15,59,99
"2321","Belarus","Eurasia","c",2011,"NF",7,6,0,3,1,0,"0",4,3,1,2,5,11,15
"2322","Belgium","Europe","c",2011,"F",1,1,12,16,11,0,"0",39,16,12,15,15,58,97
"2323","Belize","Americas","c",2011,"F",1,2,12,14,11,0,"0",37,15,11,12,13,51,88
"2324","Benin","Africa","c",2011,"F",2,2,9,16,8,0,"0",33,15,12,13,10,50,83
"2325","Bhutan","Asia","c",2011,"PF",4,5,7,7,6,1,"0",19,8,3,5,8,24,43
"2326","Bolivia","Americas","c",2011,"PF",3,3,11,11,5,0,"0",27,14,10,6,9,39,66
"2327","Bosnia and Herzegovina","Europe","c",2011,"PF",4,3,8,10,5,0,"0",23,10,7,10,10,37,60
"2328","Botswana","Africa","c",2011,"F",3,2,10,11,8,0,"0",29,13,10,12,11,46,75
"2329","Brazil","Americas","c",2011,"F",2,2,11,14,7,0,"0",32,15,10,9,12,46,78
"2330","Brunei","Asia","c",2011,"NF",6,5,0,3,3,0,"1",7,6,3,6,8,23,30
"2331","Bulgaria","Europe","c",2011,"F",2,2,12,15,8,0,"0",35,14,11,11,11,47,82
"2332","Burkina Faso","Africa","c",2011,"PF",5,3,5,8,4,0,"0",17,13,8,7,8,36,53
"2333","Burundi","Africa","c",2011,"PF",5,5,4,6,3,0,"0",13,8,4,4,6,22,35
"2334","Cambodia","Asia","c",2011,"NF",6,5,3,3,3,0,"0",9,9,4,1,6,20,29
"2335","Cameroon","Africa","c",2011,"NF",6,6,2,3,2,0,"0",7,7,3,2,4,16,23
"2336","Canada","Americas","c",2011,"F",1,1,12,16,12,0,"0",40,16,12,15,16,59,99
"2337","Cape Verde","Africa","c",2011,"F",1,1,12,15,10,0,"0",37,15,11,14,13,53,90
"2338","Central African Republic","Africa","c",2011,"PF",5,5,5,7,3,0,"0",15,10,5,3,4,22,37
"2339","Chad","Africa","c",2011,"NF",7,6,3,1,1,0,"0",5,7,4,2,3,16,21
"2340","Chile","Americas","c",2011,"F",1,1,12,15,12,0,"0",39,16,12,15,15,58,97
"2341","China","Asia","c",2011,"NF",7,6,0,1,2,1,"0",2,4,3,2,6,15,17
"2342","Colombia","Americas","c",2011,"PF",3,4,10,10,7,0,"0",27,12,5,7,10,34,61
"2343","Comoros","Africa","c",2011,"PF",3,4,9,11,5,0,"0",25,10,6,8,6,30,55
"2344","Congo (Brazzaville)","Africa","c",2011,"NF",6,5,1,3,3,0,"0",7,8,6,2,6,22,29
"2345","Congo (Kinshasa)","Africa","c",2011,"NF",6,6,6,3,2,0,"0",11,6,3,0,1,10,21
"2346","Costa Rica","Americas","c",2011,"F",1,1,12,15,11,0,"0",38,16,11,13,13,53,91
"2347","Cote d'Ivoire","Africa","c",2011,"NF",7,6,2,1,1,0,"0",4,5,4,3,4,16,20
"2348","Croatia","Europe","c",2011,"F",1,2,12,15,9,0,"0",36,14,12,11,13,50,86
"2349","Cuba","Americas","c",2011,"NF",7,6,0,0,1,0,"0",1,3,1,2,3,9,10
"2350","Cyprus","Europe","c",2011,"F",1,1,11,16,11,0,"0",38,15,12,15,14,56,94
"2351","Czech Republic","Europe","c",2011,"F",1,1,12,15,11,0,"0",38,16,12,14,15,57,95
"2352","Denmark","Europe","c",2011,"F",1,1,12,16,12,0,"0",40,16,12,14,15,57,97
"2353","Djibouti","Africa","c",2011,"NF",6,5,4,3,3,0,"0",10,7,5,5,6,23,33
"2354","Dominica","Americas","c",2011,"F",1,1,12,16,10,0,"0",38,16,12,15,15,58,96
"2355","Dominican Republic","Americas","c",2011,"F",2,2,10,12,9,0,"0",31,15,11,8,11,45,76
"2356","Ecuador","Americas","c",2011,"PF",3,3,9,14,5,0,"0",28,14,9,6,10,39,67
"2357","Egypt","Africa","c",2011,"NF",6,5,1,3,2,0,"0",6,6,2,4,7,19,25
"2358","El Salvador","Americas","c",2011,"F",2,3,12,14,8,0,"0",34,15,8,8,10,41,75
"2359","Equatorial Guinea","Africa","c",2011,"NF",7,7,0,1,0,0,"0",1,4,0,0,3,7,8
"2360","Eritrea","Africa","c",2011,"NF",7,7,0,1,1,0,"0",2,1,0,0,4,5,7
"2361","Estonia","Europe","c",2011,"F",1,1,12,15,12,0,"0",39,16,12,14,14,56,95
"2362","Ethiopia","Africa","c",2011,"NF",6,6,1,3,4,0,"0",8,4,0,4,5,13,21
"2363","Fiji","Asia","c",2011,"PF",6,4,0,5,2,0,"0",7,10,4,6,10,30,37
"2364","Finland","Europe","c",2011,"F",1,1,12,16,12,0,"0",40,16,12,16,16,60,100
"2365","France","Europe","c",2011,"F",1,1,12,15,11,0,"0",38,16,12,14,15,57,95
"2366","Gabon","Africa","c",2011,"NF",6,5,2,4,3,0,"0",9,10,4,6,5,25,34
"2367","Gaza Strip","Middle East","t",2011,"NF",6,6,5,2,2,0,"0",9,4,3,0,2,9,18
"2368","Georgia","Eurasia","c",2011,"PF",4,3,6,8,6,0,"0",20,12,7,7,10,36,56
"2369","Germany","Europe","c",2011,"F",1,1,12,15,12,0,"0",39,15,12,15,15,57,96
"2370","Ghana","Africa","c",2011,"F",1,2,12,15,10,0,"0",37,14,11,12,10,47,84
"2371","Greece","Europe","c",2011,"F",1,2,12,15,9,0,"0",36,14,12,11,13,50,86
"2372","Grenada","Americas","c",2011,"F",1,2,12,16,10,0,"0",38,15,10,12,14,51,89
"2373","Guatemala","Americas","c",2011,"PF",4,4,9,10,4,0,"0",23,12,8,6,8,34,57
"2374","Guinea","Africa","c",2011,"PF",5,5,5,8,1,0,"0",14,8,6,4,4,22,36
"2375","Guinea-Bissau","Africa","c",2011,"PF",4,4,9,7,2,0,"0",18,10,8,4,5,27,45
"2376","Guyana","Americas","c",2011,"F",2,3,11,13,7,0,"0",31,15,10,7,9,41,72
"2377","Haiti","Americas","c",2011,"PF",4,5,5,10,5,0,"0",20,10,6,4,5,25,45
"2378","Honduras","Americas","c",2011,"PF",4,4,6,8,5,0,"0",19,11,6,7,9,33,52
"2379","Hong Kong","Asia","t",2011,"PF",5,2,3,7,6,0,"0",16,14,9,15,13,51,67
"2380","Hungary","Europe","c",2011,"F",1,1,12,15,10,0,"0",37,15,12,12,14,53,90
"2381","Iceland","Europe","c",2011,"F",1,1,12,16,12,0,"0",40,16,12,16,15,59,99
"2382","India","Asia","c",2011,"F",2,3,11,14,9,0,"0",34,13,10,9,10,42,76
"2383","Indian Kashmir","Asia","t",2011,"PF",4,5,8,8,4,0,"0",20,8,5,4,8,25,45
"2384","Indonesia","Asia","c",2011,"F",2,3,11,13,6,0,"0",30,11,10,5,9,35,65
"2385","Iran","Middle East","c",2011,"NF",6,6,2,2,2,0,"0",6,2,2,3,4,11,17
"2386","Iraq","Middle East","c",2011,"NF",5,6,7,5,1,1,"0",12,5,4,0,4,13,25
"2387","Ireland","Europe","c",2011,"F",1,1,12,16,11,0,"0",39,16,12,15,15,58,97
"2388","Israel","Middle East","c",2011,"F",1,2,12,14,10,0,"0",36,13,12,11,11,47,83
"2389","Italy","Europe","c",2011,"F",1,2,12,15,10,0,"0",37,14,12,12,14,52,89
"2390","Jamaica","Americas","c",2011,"F",2,3,12,13,8,0,"0",33,15,9,6,10,40,73
"2391","Japan","Asia","c",2011,"F",1,2,12,15,10,0,"0",37,13,10,15,13,51,88
"2392","Jordan","Middle East","c",2011,"NF",6,5,2,5,3,0,"0",10,7,3,6,8,24,34
"2393","Kazakhstan","Eurasia","c",2011,"NF",6,5,2,3,1,0,"0",6,7,3,4,8,22,28
"2394","Kenya","Africa","c",2011,"PF",4,3,6,10,5,0,"0",21,14,8,7,6,35,56
"2395","Kiribati","Asia","c",2011,"F",1,1,12,16,8,0,"0",36,15,12,15,13,55,91
"2396","Kosovo","Europe","c",2011,"PF",5,4,6,7,3,1,"0",15,8,6,5,7,26,41
"2397","Kuwait","Middle East","c",2011,"PF",4,5,4,9,6,0,"0",19,7,5,7,6,25,44
"2398","Kyrgyzstan","Eurasia","c",2011,"PF",5,5,6,6,3,2,"0",13,8,5,4,7,24,37
"2399","Laos","Asia","c",2011,"NF",7,6,0,0,0,0,"0",0,4,1,2,5,12,12
"2400","Latvia","Europe","c",2011,"F",2,2,12,14,7,0,"0",33,15,12,12,13,52,85
"2401","Lebanon","Middle East","c",2011,"PF",5,3,5,9,3,0,"0",17,12,8,6,9,35,52
"2402","Lesotho","Africa","c",2011,"PF",3,3,9,11,9,0,"0",29,14,7,11,9,41,70
"2403","Liberia","Africa","c",2011,"PF",3,4,8,10,6,0,"0",24,11,8,7,8,34,58
"2404","Libya","Africa","c",2011,"NF",7,7,0,1,0,0,"0",1,1,0,0,6,7,8
"2405","Liechtenstein","Europe","c",2011,"F",1,1,12,16,12,0,"0",40,16,12,16,16,60,100
"2406","Lithuania","Europe","c",2011,"F",1,1,12,16,9,0,"0",37,16,11,13,13,53,90
"2407","Luxembourg","Europe","c",2011,"F",1,1,12,16,12,0,"0",40,16,12,16,16,60,100
"2408","Macedonia","Europe","c",2011,"PF",3,3,8,11,7,0,"0",26,12,8,9,11,40,66
"2409","Madagascar","Africa","c",2011,"PF",6,4,1,5,1,0,"0",7,10,7,6,9,32,39
"2410","Malawi","Africa","c",2011,"PF",3,4,8,11,7,0,"0",26,11,7,9,7,34,60
"2411","Malaysia","Asia","c",2011,"PF",4,4,6,8,6,0,"0",20,9,6,6,8,29,49
"2412","Maldives","Asia","c",2011,"PF",3,4,9,9,6,0,"0",24,8,8,8,8,32,56
"2413","Mali","Africa","c",2011,"F",2,3,9,13,9,0,"0",31,16,10,8,7,41,72
"2414","Malta","Europe","c",2011,"F",1,1,12,16,11,0,"0",39,16,12,15,15,58,97
"2415","Marshall Islands","Asia","c",2011,"F",1,1,11,15,10,0,"0",36,16,11,15,13,55,91
"2416","Mauritania","Africa","c",2011,"NF",6,5,3,3,5,0,"0",11,9,5,4,5,23,34
"2417","Mauritius","Africa","c",2011,"F",1,2,12,15,11,0,"0",38,15,12,13,12,52,90
"2418","Mexico","Americas","c",2011,"PF",3,3,10,12,7,0,"0",29,13,8,6,10,37,66
"2419","Micronesia","Asia","c",2011,"F",1,1,12,15,10,0,"0",37,16,11,15,14,56,93
"2420","Moldova","Eurasia","c",2011,"PF",3,3,10,12,5,0,"0",27,11,8,8,9,36,63
"2421","Monaco","Europe","c",2011,"F",2,1,10,11,10,0,"0",31,15,12,15,14,56,87
"2422","Mongolia","Asia","c",2011,"F",2,2,10,15,10,0,"0",35,15,11,12,12,50,85
"2423","Montenegro","Europe","c",2011,"F",3,2,9,11,7,0,"0",27,13,10,10,12,45,72
"2424","Morocco","Africa","c",2011,"PF",5,4,4,6,4,0,"0",14,8,6,6,8,28,42
"2425","Mozambique","Africa","c",2011,"PF",4,3,6,10,7,0,"0",23,12,7,8,9,36,59
"2426","Myanmar","Asia","c",2011,"NF",7,7,0,3,0,3,"0",0,2,0,0,3,5,5
"2427","Nagorno-Karabakh","Eurasia","t",2011,"NF",6,5,4,3,3,0,"0",10,6,3,5,5,19,29
"2428","Namibia","Africa","c",2011,"F",2,2,10,11,9,0,"0",30,14,12,10,9,45,75
"2429","Nauru","Asia","c",2011,"F",1,1,12,16,10,0,"0",38,15,11,15,14,55,93
"2430","Nepal","Asia","c",2011,"PF",4,4,6,11,3,0,"0",20,9,6,6,7,28,48
"2431","Netherlands","Europe","c",2011,"F",1,1,12,16,12,0,"0",40,16,12,14,16,58,98
"2432","New Zealand","Asia","c",2011,"F",1,1,12,15,12,0,"0",39,16,12,15,15,58,97
"2433","Nicaragua","Americas","c",2011,"PF",4,4,9,7,4,0,"0",20,12,6,7,9,34,54
"2434","Niger","Africa","c",2011,"PF",5,4,2,6,4,0,"0",12,11,8,5,6,30,42
"2435","Nigeria","Africa","c",2011,"PF",4,4,4,9,6,0,"0",19,9,8,5,7,29,48
"2436","North Korea","Asia","c",2011,"NF",7,7,0,0,0,0,"0",0,0,0,0,1,1,1
"2437","Northern Cyprus","Europe","t",2011,"F",2,2,11,14,9,0,"0",34,14,9,12,12,47,81
"2438","Norway","Europe","c",2011,"F",1,1,12,16,12,0,"0",40,16,12,16,16,60,100
"2439","Oman","Middle East","c",2011,"NF",6,5,2,2,2,0,"3",9,6,3,4,5,18,27
"2440","Pakistan","Asia","c",2011,"PF",4,5,6,9,5,0,"0",20,7,7,4,6,24,44
"2441","Pakistani Kashmir","Asia","t",2011,"NF",6,5,3,4,3,2,"0",8,6,5,4,6,21,29
"2442","Palau","Asia","c",2011,"F",1,1,12,15,10,0,"0",37,16,11,15,13,55,92
"2443","Panama","Americas","c",2011,"F",1,2,12,15,9,0,"0",36,15,11,9,12,47,83
"2444","Papua New Guinea","Asia","c",2011,"PF",4,3,9,10,4,0,"0",23,12,9,7,8,36,59
"2445","Paraguay","Americas","c",2011,"PF",3,3,11,12,5,0,"0",28,12,8,6,10,36,64
"2446","Peru","Americas","c",2011,"F",2,3,11,13,7,0,"0",31,15,8,8,10,41,72
"2447","Philippines","Asia","c",2011,"PF",3,3,9,10,6,0,"0",25,14,8,4,10,36,61
"2448","Poland","Europe","c",2011,"F",1,1,12,16,10,0,"0",38,16,12,13,14,55,93
"2449","Portugal","Europe","c",2011,"F",1,1,12,16,11,0,"0",39,16,12,15,15,58,97
"2450","Puerto Rico","Americas","t",2011,"F",1,1,12,15,10,0,"0",37,16,10,13,14,53,90
"2451","Qatar","Middle East","c",2011,"NF",6,5,2,2,3,0,"3",10,8,2,4,4,18,28
"2452","Romania","Europe","c",2011,"F",2,2,12,14,8,0,"0",34,14,11,12,12,49,83
"2453","Russia","Eurasia","c",2011,"NF",6,5,1,3,3,0,"0",7,6,4,3,7,20,27
"2454","Rwanda","Africa","c",2011,"NF",6,5,2,2,4,0,"0",8,4,3,5,7,19,27
"2455","Samoa","Asia","c",2011,"F",2,2,9,13,10,0,"0",32,14,10,13,12,49,81
"2456","San Marino","Europe","c",2011,"F",1,1,12,16,12,0,"0",40,16,12,16,16,60,100
"2457","Sao Tome and Principe","Africa","c",2011,"F",2,2,11,14,8,0,"0",33,15,10,12,10,47,80
"2458","Saudi Arabia","Middle East","c",2011,"NF",7,6,0,0,1,0,"2",3,4,0,3,2,9,12
"2459","Senegal","Africa","c",2011,"PF",3,3,9,12,7,0,"0",28,14,10,10,9,43,71
"2460","Serbia","Europe","c",2011,"F",2,2,9,14,7,0,"0",30,15,11,9,13,48,78
"2461","Seychelles","Africa","c",2011,"PF",3,3,8,10,7,0,"0",25,11,9,11,11,42,67
"2462","Sierra Leone","Africa","c",2011,"PF",3,3,10,11,6,0,"0",27,12,8,8,9,37,64
"2463","Singapore","Asia","c",2011,"PF",5,4,4,6,7,0,"0",17,9,3,7,12,31,48
"2464","Slovakia","Europe","c",2011,"F",1,1,12,15,10,0,"0",37,15,12,12,14,53,90
"2465","Slovenia","Europe","c",2011,"F",1,1,12,15,11,0,"0",38,14,12,14,13,53,91
"2466","Solomon Islands","Asia","c",2011,"PF",4,3,6,10,6,0,"0",22,13,9,8,12,42,64
"2467","Somalia","Africa","c",2011,"NF",7,7,0,0,0,0,"0",0,1,0,0,0,1,1
"2468","Somaliland","Africa","t",2011,"PF",4,5,5,10,5,0,"0",20,7,5,7,6,25,45
"2469","South Africa","Africa","c",2011,"F",2,2,12,14,9,0,"0",35,15,12,10,11,48,83
"2470","South Korea","Asia","c",2011,"F",1,2,11,15,10,0,"0",36,14,11,13,12,50,86
"2471","South Ossetia","Eurasia","t",2011,"NF",7,6,0,0,0,3,"0",-3,5,1,1,3,10,7
"2472","Spain","Europe","c",2011,"F",1,1,12,16,12,0,"0",40,16,12,14,15,57,97
"2473","Sri Lanka","Asia","c",2011,"PF",5,4,6,6,5,0,"0",17,8,6,6,8,28,45
"2474","St. Kitts and Nevis","Americas","c",2011,"F",1,1,12,16,11,0,"0",39,15,12,12,14,53,92
"2475","St. Lucia","Americas","c",2011,"F",1,1,12,16,11,0,"0",39,15,12,12,14,53,92
"2476","St. Vincent and the Grenadines","Americas","c",2011,"F",1,1,11,16,9,0,"0",36,15,11,13,14,53,89
"2477","Sudan","Africa","c",2011,"NF",7,7,2,4,3,4,"0",5,4,2,0,0,6,11
"2478","Suriname","Americas","c",2011,"F",2,2,12,13,8,0,"0",33,15,11,9,10,45,78
"2479","Swaziland","Africa","c",2011,"NF",7,5,0,1,1,0,"1",3,8,3,5,4,20,23
"2480","Sweden","Europe","c",2011,"F",1,1,12,16,12,0,"0",40,16,12,16,16,60,100
"2481","Switzerland","Europe","c",2011,"F",1,1,12,15,12,0,"0",39,15,12,15,15,57,96
"2482","Syria","Middle East","c",2011,"NF",7,6,0,0,1,0,"0",1,2,0,1,5,8,9
"2483","Taiwan","Asia","c",2011,"F",1,2,11,15,10,0,"0",36,14,10,14,13,51,87
"2484","Tajikistan","Eurasia","c",2011,"NF",6,5,2,4,2,0,"0",8,6,4,4,4,18,26
"2485","Tanzania","Africa","c",2011,"PF",3,3,9,12,7,0,"0",28,11,7,10,8,36,64
"2486","Thailand","Asia","c",2011,"PF",5,4,3,5,4,0,"0",12,9,5,6,10,30,42
"2487","The Gambia","Africa","c",2011,"PF",5,5,6,7,2,0,"0",15,8,4,4,7,23,38
"2488","Tibet","Asia","t",2011,"NF",7,7,0,0,1,3,"0",-2,0,0,0,3,3,1
"2489","Timor-Leste","Asia","c",2011,"PF",3,4,11,11,6,0,"0",28,12,7,6,9,34,62
"2490","Togo","Africa","c",2011,"PF",5,4,5,8,3,0,"0",16,8,5,6,7,26,42
"2491","Tonga","Asia","c",2011,"PF",3,3,11,14,4,0,"0",29,12,7,11,12,42,71
"2492","Transnistria","Eurasia","t",2011,"NF",6,6,2,4,1,0,"0",7,6,2,2,5,15,22
"2493","Trinidad and Tobago","Americas","c",2011,"F",2,2,11,13,9,0,"0",33,15,11,10,13,49,82
"2494","Tunisia","Africa","c",2011,"NF",7,5,1,3,1,0,"0",5,4,2,4,8,18,23
"2495","Turkey","Europe","c",2011,"PF",3,3,10,10,7,0,"0",27,11,7,8,10,36,63
"2496","Turkmenistan","Eurasia","c",2011,"NF",7,7,0,1,0,0,"0",1,3,0,1,3,7,8
"2497","Tuvalu","Asia","c",2011,"F",1,1,12,15,10,0,"0",37,16,12,15,14,57,94
"2498","Uganda","Africa","c",2011,"PF",5,4,4,7,4,0,"0",15,11,6,6,7,30,45
"2499","Ukraine","Eurasia","c",2011,"PF",3,3,9,13,5,0,"0",27,11,9,9,11,40,67
"2500","United Arab Emirates","Middle East","c",2011,"NF",6,5,1,2,2,0,"3",8,8,3,4,4,19,27
"2501","United Kingdom","Europe","c",2011,"F",1,1,12,16,12,0,"0",40,15,12,15,15,57,97
"2502","United States","Americas","c",2011,"F",1,1,11,16,11,0,"0",38,16,11,14,15,56,94
"2503","Uruguay","Americas","c",2011,"F",1,1,12,16,11,0,"0",39,16,12,15,15,58,97
"2504","Uzbekistan","Eurasia","c",2011,"NF",7,7,0,0,0,0,"0",0,1,0,0,3,4,4
"2505","Vanuatu","Asia","c",2011,"F",2,2,9,15,8,0,"0",32,16,11,10,11,48,80
"2506","Venezuela","Americas","c",2011,"PF",5,5,6,8,3,0,"0",17,9,4,5,7,25,42
"2507","Vietnam","Asia","c",2011,"NF",7,5,0,1,1,0,"0",2,5,1,4,8,18,20
"2508","West Bank","Middle East","t",2011,"NF",6,5,2,5,2,2,"0",7,9,6,5,5,25,32
"2509","Western Sahara","Africa","t",2011,"NF",7,6,0,0,0,2,"0",-2,3,2,0,5,10,8
"2510","Yemen","Middle East","c",2011,"NF",6,5,4,4,3,0,"0",11,7,3,3,5,18,29
"2511","Zambia","Africa","c",2011,"PF",3,4,8,11,6,0,"0",25,11,7,8,7,33,58
"2512","Zimbabwe","Africa","c",2011,"NF",6,6,2,4,2,0,"0",8,5,3,1,4,13,21
"2513","Abkhazia","Eurasia","t",2010,"PF",5,5,5,5,4,0,"0",14,7,5,4,5,21,35
"2514","Afghanistan","Asia","c",2010,"NF",6,6,4,6,1,0,"0",11,5,4,2,5,16,27
"2515","Albania","Europe","c",2010,"PF",3,3,8,11,7,0,"0",26,13,8,9,9,39,65
"2516","Algeria","Africa","c",2010,"NF",6,5,4,4,3,0,"0",11,7,6,5,7,25,36
"2517","Andorra","Europe","c",2010,"F",1,1,12,15,12,0,"0",39,16,11,15,15,57,96
"2518","Angola","Africa","c",2010,"NF",6,5,3,6,1,0,"0",10,8,6,4,3,21,31
"2519","Antigua and Barbuda","Americas","c",2010,"F",3,2,11,12,6,0,"0",29,13,9,12,13,47,76
"2520","Argentina","Americas","c",2010,"F",2,2,11,15,6,0,"0",32,14,11,10,13,48,80
"2521","Armenia","Eurasia","c",2010,"PF",6,4,4,4,3,0,"0",11,8,5,6,9,28,39
"2522","Australia","Asia","c",2010,"F",1,1,12,15,12,0,"0",39,16,12,14,15,57,96
"2523","Austria","Europe","c",2010,"F",1,1,12,15,12,0,"0",39,16,12,15,15,58,97
"2524","Azerbaijan","Eurasia","c",2010,"NF",6,5,2,3,3,0,"0",8,6,3,4,8,21,29
"2525","Bahamas","Americas","c",2010,"F",1,1,12,16,10,0,"0",38,16,12,15,15,58,96
"2526","Bahrain","Middle East","c",2010,"NF",6,5,3,6,4,2,"0",11,8,3,3,7,21,32
"2527","Bangladesh","Asia","c",2010,"PF",3,4,9,11,6,0,"0",26,9,8,7,9,33,59
"2528","Barbados","Americas","c",2010,"F",1,1,12,16,12,0,"0",40,16,12,16,15,59,99
"2529","Belarus","Eurasia","c",2010,"NF",7,6,0,3,1,0,"0",4,3,1,2,5,11,15
"2530","Belgium","Europe","c",2010,"F",1,1,12,16,12,0,"0",40,16,12,15,15,58,98
"2531","Belize","Americas","c",2010,"F",1,2,12,14,11,0,"0",37,15,11,12,13,51,88
"2532","Benin","Africa","c",2010,"F",2,2,9,15,8,0,"0",32,15,12,11,10,48,80
"2533","Bhutan","Asia","c",2010,"PF",4,5,7,7,6,1,"0",19,8,3,5,8,24,43
"2534","Bolivia","Americas","c",2010,"PF",3,3,11,12,5,0,"0",28,14,10,7,9,40,68
"2535","Bosnia and Herzegovina","Europe","c",2010,"PF",4,3,8,10,5,0,"0",23,11,7,10,10,38,61
"2536","Botswana","Africa","c",2010,"F",3,2,10,11,8,0,"0",29,13,10,12,11,46,75
"2537","Brazil","Americas","c",2010,"F",2,2,11,14,7,0,"0",32,15,10,8,12,45,77
"2538","Brunei","Asia","c",2010,"NF",6,5,0,3,3,0,"1",7,6,3,6,8,23,30
"2539","Bulgaria","Europe","c",2010,"F",2,2,12,15,8,0,"0",35,14,11,11,11,47,82
"2540","Burkina Faso","Africa","c",2010,"PF",5,3,5,8,4,0,"0",17,13,8,6,8,35,52
"2541","Burundi","Africa","c",2010,"PF",4,5,9,9,4,0,"0",22,8,5,4,6,23,45
"2542","Cambodia","Asia","c",2010,"NF",6,5,3,5,3,0,"0",11,9,5,1,6,21,32
"2543","Cameroon","Africa","c",2010,"NF",6,6,2,3,3,0,"0",8,7,3,2,4,16,24
"2544","Canada","Americas","c",2010,"F",1,1,12,16,12,0,"0",40,16,12,15,16,59,99
"2545","Cape Verde","Africa","c",2010,"F",1,1,12,15,10,0,"0",37,15,11,14,13,53,90
"2546","Central African Republic","Africa","c",2010,"PF",5,5,7,7,3,0,"0",17,10,5,3,4,22,39
"2547","Chad","Africa","c",2010,"NF",7,6,3,1,1,0,"0",5,7,4,1,3,15,20
"2548","Chile","Americas","c",2010,"F",1,1,12,15,12,0,"0",39,16,12,15,15,58,97
"2549","China","Asia","c",2010,"NF",7,6,0,1,1,1,"0",1,4,3,2,7,16,17
"2550","Colombia","Americas","c",2010,"PF",3,4,10,9,7,0,"0",26,11,5,7,10,33,59
"2551","Comoros","Africa","c",2010,"PF",3,4,9,11,5,0,"0",25,10,6,8,6,30,55
"2552","Congo (Brazzaville)","Africa","c",2010,"NF",6,5,1,3,3,0,"0",7,8,6,2,6,22,29
"2553","Congo (Kinshasa)","Africa","c",2010,"NF",6,6,6,3,2,0,"0",11,6,3,0,1,10,21
"2554","Costa Rica","Americas","c",2010,"F",1,1,12,15,11,0,"0",38,16,11,13,13,53,91
"2555","Cote d'Ivoire","Africa","c",2010,"NF",6,5,1,3,2,0,"0",6,5,4,6,5,20,26
"2556","Croatia","Europe","c",2010,"F",1,2,12,15,9,0,"0",36,14,12,11,13,50,86
"2557","Cuba","Americas","c",2010,"NF",7,6,0,0,1,0,"0",1,2,1,2,3,8,9
"2558","Cyprus","Europe","c",2010,"F",1,1,11,16,11,0,"0",38,15,12,15,14,56,94
"2559","Czech Republic","Europe","c",2010,"F",1,1,12,15,11,0,"0",38,16,12,14,15,57,95
"2560","Denmark","Europe","c",2010,"F",1,1,12,16,12,0,"0",40,16,11,14,15,56,96
"2561","Djibouti","Africa","c",2010,"PF",5,5,4,5,3,0,"0",12,7,5,5,6,23,35
"2562","Dominica","Americas","c",2010,"F",1,1,12,16,10,0,"0",38,16,12,15,15,58,96
"2563","Dominican Republic","Americas","c",2010,"F",2,2,11,13,9,0,"0",33,15,11,8,11,45,78
"2564","Ecuador","Americas","c",2010,"PF",3,3,9,14,6,0,"0",29,14,9,6,10,39,68
"2565","Egypt","Africa","c",2010,"NF",6,5,1,4,2,0,"0",7,7,2,4,7,20,27
"2566","El Salvador","Americas","c",2010,"F",2,3,12,14,8,0,"0",34,15,8,7,10,40,74
"2567","Equatorial Guinea","Africa","c",2010,"NF",7,7,0,1,0,0,"0",1,4,0,0,3,7,8
"2568","Eritrea","Africa","c",2010,"NF",7,7,0,1,2,0,"0",3,1,0,0,4,5,8
"2569","Estonia","Europe","c",2010,"F",1,1,12,15,12,0,"0",39,16,12,14,14,56,95
"2570","Ethiopia","Africa","c",2010,"PF",5,5,5,4,4,0,"0",13,6,2,4,6,18,31
"2571","Fiji","Asia","c",2010,"PF",6,4,0,5,2,0,"0",7,10,4,7,10,31,38
"2572","Finland","Europe","c",2010,"F",1,1,12,16,12,0,"0",40,16,12,16,16,60,100
"2573","France","Europe","c",2010,"F",1,1,12,15,11,0,"0",38,16,12,15,15,58,96
"2574","Gabon","Africa","c",2010,"NF",6,5,2,4,3,0,"0",9,10,4,6,5,25,34
"2575","Georgia","Eurasia","c",2010,"PF",4,4,6,8,6,0,"0",20,11,7,6,10,34,54
"2576","Germany","Europe","c",2010,"F",1,1,12,15,12,0,"0",39,15,12,15,15,57,96
"2577","Ghana","Africa","c",2010,"F",1,2,12,15,10,0,"0",37,14,11,12,10,47,84
"2578","Greece","Europe","c",2010,"F",1,2,12,15,9,0,"0",36,14,12,11,13,50,86
"2579","Grenada","Americas","c",2010,"F",1,2,12,16,10,0,"0",38,15,10,12,15,52,90
"2580","Guatemala","Americas","c",2010,"PF",4,4,9,10,4,0,"0",23,12,8,5,8,33,56
"2581","Guinea","Africa","c",2010,"NF",7,6,0,2,0,0,"0",2,6,2,0,5,13,15
"2582","Guinea-Bissau","Africa","c",2010,"PF",4,4,9,9,3,0,"0",21,10,8,4,5,27,48
"2583","Guyana","Americas","c",2010,"F",2,3,11,13,7,0,"0",31,15,10,7,9,41,72
"2584","Haiti","Americas","c",2010,"PF",4,5,7,10,5,0,"0",22,10,6,4,5,25,47
"2585","Honduras","Americas","c",2010,"PF",4,4,6,8,4,0,"0",18,11,6,7,9,33,51
"2586","Hong Kong","Asia","t",2010,"PF",5,2,3,7,6,0,"0",16,14,10,15,13,52,68
"2587","Hungary","Europe","c",2010,"F",1,1,12,15,10,0,"0",37,16,12,12,14,54,91
"2588","Iceland","Europe","c",2010,"F",1,1,12,16,12,0,"0",40,16,12,16,15,59,99
"2589","India","Asia","c",2010,"F",2,3,11,14,9,0,"0",34,13,10,9,10,42,76
"2590","Indian Kashmir","Asia","t",2010,"PF",4,4,8,8,4,0,"0",20,8,6,4,8,26,46
"2591","Indonesia","Asia","c",2010,"F",2,3,11,13,6,0,"0",30,11,9,6,9,35,65
"2592","Iran","Middle East","c",2010,"NF",6,6,2,2,3,0,"0",7,3,3,3,4,13,20
"2593","Iraq","Middle East","c",2010,"NF",5,6,7,5,2,2,"0",12,5,4,1,4,14,26
"2594","Ireland","Europe","c",2010,"F",1,1,12,16,11,0,"0",39,16,12,15,15,58,97
"2595","Israel","Middle East","c",2010,"F",1,2,12,14,10,0,"0",36,13,11,11,11,46,82
"2596","Israeli Occupied Territories","Middle East","t",2010,"NF",6,6,3,2,3,2,"0",6,6,5,1,3,15,21
"2597","Italy","Europe","c",2010,"F",1,2,12,15,10,0,"0",37,14,12,12,14,52,89
"2598","Jamaica","Americas","c",2010,"F",2,3,12,14,8,0,"0",34,15,9,7,10,41,75
"2599","Japan","Asia","c",2010,"F",1,2,12,15,10,0,"0",37,13,10,15,13,51,88
"2600","Jordan","Middle East","c",2010,"NF",6,5,2,5,3,0,"0",10,7,3,6,8,24,34
"2601","Kazakhstan","Eurasia","c",2010,"NF",6,5,2,3,2,0,"0",7,7,3,4,7,21,28
"2602","Kenya","Africa","c",2010,"PF",4,4,6,9,4,0,"0",19,13,8,6,6,33,52
"2603","Kiribati","Asia","c",2010,"F",1,1,12,16,8,0,"0",36,15,12,15,13,55,91
"2604","Kosovo","Europe","c",2010,"PF",5,4,6,7,3,2,"0",14,8,6,5,7,26,40
"2605","Kuwait","Middle East","c",2010,"PF",4,4,4,9,6,0,"0",19,8,6,7,6,27,46
"2606","Kyrgyzstan","Eurasia","c",2010,"NF",6,5,3,5,3,0,"0",11,8,5,5,7,25,36
"2607","Laos","Asia","c",2010,"NF",7,6,0,1,0,0,"0",1,4,1,2,5,12,13
"2608","Latvia","Europe","c",2010,"F",2,1,12,14,7,0,"0",33,16,12,12,13,53,86
"2609","Lebanon","Middle East","c",2010,"PF",5,3,5,9,3,0,"0",17,12,8,6,9,35,52
"2610","Lesotho","Africa","c",2010,"PF",3,3,9,11,9,0,"0",29,14,7,11,9,41,70
"2611","Liberia","Africa","c",2010,"PF",3,4,8,10,6,0,"0",24,11,8,7,8,34,58
"2612","Libya","Africa","c",2010,"NF",7,7,0,1,0,0,"0",1,1,0,0,6,7,8
"2613","Liechtenstein","Europe","c",2010,"F",1,1,12,16,12,0,"0",40,16,12,16,16,60,100
"2614","Lithuania","Europe","c",2010,"F",1,1,12,16,9,0,"0",37,16,11,13,13,53,90
"2615","Luxembourg","Europe","c",2010,"F",1,1,12,16,12,0,"0",40,16,12,16,16,60,100
"2616","Macedonia","Europe","c",2010,"PF",3,3,8,10,7,0,"0",25,12,7,9,10,38,63
"2617","Madagascar","Africa","c",2010,"PF",6,4,2,5,2,0,"0",9,10,7,6,9,32,41
"2618","Malawi","Africa","c",2010,"PF",3,4,8,11,7,0,"0",26,11,8,8,7,34,60
"2619","Malaysia","Asia","c",2010,"PF",4,4,6,8,6,0,"0",20,9,6,6,8,29,49
"2620","Maldives","Asia","c",2010,"PF",3,4,9,9,7,0,"0",25,8,8,8,8,32,57
"2621","Mali","Africa","c",2010,"F",2,3,9,13,9,0,"0",31,16,10,7,7,40,71
"2622","Malta","Europe","c",2010,"F",1,1,12,16,11,0,"0",39,16,12,15,15,58,97
"2623","Marshall Islands","Asia","c",2010,"F",1,1,11,15,10,0,"0",36,16,11,15,13,55,91
"2624","Mauritania","Africa","c",2010,"NF",6,5,3,3,5,0,"0",11,9,5,4,5,23,34
"2625","Mauritius","Africa","c",2010,"F",1,2,12,15,11,0,"0",38,15,12,13,12,52,90
"2626","Mexico","Americas","c",2010,"F",2,3,10,12,8,0,"0",30,14,8,6,11,39,69
"2627","Micronesia","Asia","c",2010,"F",1,1,12,15,10,0,"0",37,16,11,15,14,56,93
"2628","Moldova","Eurasia","c",2010,"PF",3,4,9,11,5,0,"0",25,10,6,8,9,33,58
"2629","Monaco","Europe","c",2010,"F",2,1,10,11,10,0,"0",31,15,12,15,14,56,87
"2630","Mongolia","Asia","c",2010,"F",2,2,10,15,10,0,"0",35,15,11,12,12,50,85
"2631","Montenegro","Europe","c",2010,"F",3,2,9,9,7,0,"0",25,13,10,9,12,44,69
"2632","Morocco","Africa","c",2010,"PF",5,4,4,6,4,0,"0",14,8,6,6,8,28,42
"2633","Mozambique","Africa","c",2010,"PF",4,3,6,10,7,0,"0",23,12,7,8,9,36,59
"2634","Myanmar","Asia","c",2010,"NF",7,7,0,0,0,3,"0",-3,2,0,0,3,5,2
"2635","Nagorno-Karabakh","Eurasia","t",2010,"PF",5,5,6,4,3,0,"0",13,6,3,5,5,19,32
"2636","Namibia","Africa","c",2010,"F",2,2,10,11,9,0,"0",30,15,12,10,9,46,76
"2637","Nauru","Asia","c",2010,"F",1,1,12,16,10,0,"0",38,15,11,15,14,55,93
"2638","Nepal","Asia","c",2010,"PF",4,4,6,11,4,0,"0",21,10,6,6,7,29,50
"2639","Netherlands","Europe","c",2010,"F",1,1,12,16,12,0,"0",40,16,12,15,16,59,99
"2640","New Zealand","Asia","c",2010,"F",1,1,12,15,12,0,"0",39,16,12,15,15,58,97
"2641","Nicaragua","Americas","c",2010,"PF",4,4,9,7,4,0,"0",20,12,6,7,9,34,54
"2642","Niger","Africa","c",2010,"PF",5,4,3,6,4,0,"0",13,10,8,5,6,29,42
"2643","Nigeria","Africa","c",2010,"PF",5,4,3,7,6,0,"0",16,9,8,5,7,29,45
"2644","North Korea","Asia","c",2010,"NF",7,7,0,0,0,0,"0",0,0,0,0,1,1,1
"2645","Northern Cyprus","Europe","t",2010,"F",2,2,11,14,9,0,"0",34,14,9,12,12,47,81
"2646","Norway","Europe","c",2010,"F",1,1,12,16,12,0,"0",40,16,12,16,16,60,100
"2647","Oman","Middle East","c",2010,"NF",6,5,2,2,2,0,"3",9,6,3,4,5,18,27
"2648","Pakistan","Asia","c",2010,"PF",4,5,6,9,4,0,"0",19,7,7,4,6,24,43
"2649","Pakistani Kashmir","Asia","t",2010,"NF",6,5,3,4,3,2,"0",8,6,5,4,6,21,29
"2650","Palau","Asia","c",2010,"F",1,1,12,15,10,0,"0",37,16,11,15,13,55,92
"2651","Palestinian Authority Administered Territories","Middle East","t",2010,"NF",6,6,4,5,2,0,"0",11,5,3,1,5,14,25
"2652","Panama","Americas","c",2010,"F",1,2,12,15,9,0,"0",36,15,11,9,12,47,83
"2653","Papua New Guinea","Asia","c",2010,"PF",4,3,9,10,4,0,"0",23,12,9,7,8,36,59
"2654","Paraguay","Americas","c",2010,"PF",3,3,11,12,5,0,"0",28,12,8,6,10,36,64
"2655","Peru","Americas","c",2010,"F",2,3,11,13,7,0,"0",31,15,8,8,10,41,72
"2656","Philippines","Asia","c",2010,"PF",4,3,6,9,6,0,"0",21,13,8,5,10,36,57
"2657","Poland","Europe","c",2010,"F",1,1,12,16,10,0,"0",38,16,12,13,14,55,93
"2658","Portugal","Europe","c",2010,"F",1,1,12,16,11,0,"0",39,16,12,15,15,58,97
"2659","Puerto Rico","Americas","t",2010,"F",1,1,12,15,10,0,"0",37,16,11,14,14,55,92
"2660","Qatar","Middle East","c",2010,"NF",6,5,2,2,3,0,"3",10,8,2,4,4,18,28
"2661","Romania","Europe","c",2010,"F",2,2,12,14,8,0,"0",34,14,11,12,12,49,83
"2662","Russia","Eurasia","c",2010,"NF",6,5,1,3,3,0,"0",7,6,4,3,7,20,27
"2663","Rwanda","Africa","c",2010,"NF",6,5,3,3,4,0,"0",10,7,4,6,7,24,34
"2664","Samoa","Asia","c",2010,"F",2,2,9,13,10,0,"0",32,14,10,13,12,49,81
"2665","San Marino","Europe","c",2010,"F",1,1,12,16,12,0,"0",40,16,12,16,16,60,100
"2666","Sao Tome and Principe","Africa","c",2010,"F",2,2,11,14,8,0,"0",33,15,10,12,10,47,80
"2667","Saudi Arabia","Middle East","c",2010,"NF",7,6,0,0,1,0,"2",3,4,0,3,2,9,12
"2668","Senegal","Africa","c",2010,"PF",3,3,9,12,8,0,"0",29,14,10,10,9,43,72
"2669","Serbia","Europe","c",2010,"F",2,2,9,14,7,0,"0",30,15,11,9,13,48,78
"2670","Seychelles","Africa","c",2010,"PF",3,3,8,10,7,0,"0",25,11,9,11,11,42,67
"2671","Sierra Leone","Africa","c",2010,"PF",3,3,10,11,6,0,"0",27,12,8,8,9,37,64
"2672","Singapore","Asia","c",2010,"PF",5,4,4,6,7,0,"0",17,9,3,7,12,31,48
"2673","Slovakia","Europe","c",2010,"F",1,1,12,15,10,0,"0",37,15,12,12,14,53,90
"2674","Slovenia","Europe","c",2010,"F",1,1,12,15,11,0,"0",38,14,12,14,13,53,91
"2675","Solomon Islands","Asia","c",2010,"PF",4,3,6,10,6,0,"0",22,13,9,8,12,42,64
"2676","Somalia","Africa","c",2010,"NF",7,7,0,0,0,0,"0",0,1,0,0,0,1,1
"2677","Somaliland","Africa","t",2010,"PF",5,5,4,7,5,0,"0",16,7,5,6,6,24,40
"2678","South Africa","Africa","c",2010,"F",2,2,12,14,9,0,"0",35,15,12,10,12,49,84
"2679","South Korea","Asia","c",2010,"F",1,2,11,15,10,0,"0",36,14,11,13,12,50,86
"2680","South Ossetia","Eurasia","t",2010,"NF",7,6,0,0,0,3,"0",-3,4,0,1,3,8,5
"2681","Spain","Europe","c",2010,"F",1,1,12,16,12,0,"0",40,16,12,14,15,57,97
"2682","Sri Lanka","Asia","c",2010,"PF",4,4,8,8,6,0,"0",22,8,7,6,9,30,52
"2683","St. Kitts and Nevis","Americas","c",2010,"F",1,1,12,16,11,0,"0",39,15,12,12,14,53,92
"2684","St. Lucia","Americas","c",2010,"F",1,1,12,16,11,0,"0",39,15,12,12,14,53,92
"2685","St. Vincent and the Grenadines","Americas","c",2010,"F",2,1,11,15,9,0,"0",35,15,11,13,14,53,88
"2686","Sudan","Africa","c",2010,"NF",7,7,0,4,3,4,"0",3,4,2,0,0,6,9
"2687","Suriname","Americas","c",2010,"F",2,2,12,13,8,0,"0",33,15,11,9,10,45,78
"2688","Swaziland","Africa","c",2010,"NF",7,5,0,1,1,0,"1",3,8,3,5,5,21,24
"2689","Sweden","Europe","c",2010,"F",1,1,12,16,12,0,"0",40,16,12,16,16,60,100
"2690","Switzerland","Europe","c",2010,"F",1,1,12,15,12,0,"0",39,15,12,15,15,57,96
"2691","Syria","Middle East","c",2010,"NF",7,6,0,0,1,0,"0",1,2,0,1,5,8,9
"2692","Taiwan","Asia","c",2010,"F",1,2,11,15,10,0,"0",36,15,10,14,13,52,88
"2693","Tajikistan","Eurasia","c",2010,"NF",6,5,2,4,2,0,"0",8,6,4,4,5,19,27
"2694","Tanzania","Africa","c",2010,"PF",4,3,6,9,6,0,"0",21,11,7,10,8,36,57
"2695","Thailand","Asia","c",2010,"PF",5,4,3,5,4,0,"0",12,9,6,6,11,32,44
"2696","The Gambia","Africa","c",2010,"PF",5,5,6,7,2,0,"0",15,8,5,4,7,24,39
"2697","Tibet","Asia","t",2010,"NF",7,7,0,0,1,3,"0",-2,0,0,0,3,3,1
"2698","Timor-Leste","Asia","c",2010,"PF",3,4,11,11,6,0,"0",28,12,7,6,9,34,62
"2699","Togo","Africa","c",2010,"PF",5,4,5,8,3,0,"0",16,8,6,6,7,27,43
"2700","Tonga","Asia","c",2010,"PF",5,3,3,9,3,0,"0",15,12,5,11,12,40,55
"2701","Transnistria","Eurasia","t",2010,"NF",6,6,2,4,1,0,"0",7,6,2,2,5,15,22
"2702","Trinidad and Tobago","Americas","c",2010,"F",2,2,11,12,9,0,"0",32,15,11,10,13,49,81
"2703","Tunisia","Africa","c",2010,"NF",7,5,1,3,1,0,"0",5,4,2,4,8,18,23
"2704","Turkey","Europe","c",2010,"PF",3,3,10,10,7,0,"0",27,11,7,8,10,36,63
"2705","Turkmenistan","Eurasia","c",2010,"NF",7,7,0,1,0,0,"0",1,3,0,1,3,7,8
"2706","Tuvalu","Asia","c",2010,"F",1,1,12,15,10,0,"0",37,16,12,15,14,57,94
"2707","Uganda","Africa","c",2010,"PF",5,4,4,7,4,0,"0",15,11,6,6,7,30,45
"2708","Ukraine","Eurasia","c",2010,"F",3,2,10,13,5,0,"0",28,13,11,10,11,45,73
"2709","United Arab Emirates","Middle East","c",2010,"NF",6,5,1,2,2,0,"3",8,8,3,4,4,19,27
"2710","United Kingdom","Europe","c",2010,"F",1,1,12,16,12,0,"0",40,15,12,14,15,56,96
"2711","United States","Americas","c",2010,"F",1,1,11,16,11,0,"0",38,16,11,14,15,56,94
"2712","Uruguay","Americas","c",2010,"F",1,1,12,16,11,0,"0",39,16,12,15,15,58,97
"2713","Uzbekistan","Eurasia","c",2010,"NF",7,7,0,0,0,0,"0",0,1,0,0,3,4,4
"2714","Vanuatu","Asia","c",2010,"F",2,2,9,15,8,0,"0",32,16,11,10,11,48,80
"2715","Venezuela","Americas","c",2010,"PF",5,4,6,7,3,0,"0",16,9,5,5,8,27,43
"2716","Vietnam","Asia","c",2010,"NF",7,5,0,1,1,0,"0",2,6,1,4,8,19,21
"2717","Western Sahara","Africa","t",2010,"NF",7,6,0,0,0,2,"0",-2,3,2,0,5,10,8
"2718","Yemen","Middle East","c",2010,"NF",6,5,4,4,3,0,"0",11,7,3,3,5,18,29
"2719","Zambia","Africa","c",2010,"PF",3,4,8,12,6,0,"0",26,11,7,9,7,34,60
"2720","Zimbabwe","Africa","c",2010,"NF",6,6,2,4,1,0,"0",7,4,3,1,2,10,17
"2721","Abkhazia","Eurasia","t",2009,"PF",5,5,5,5,4,0,"0",14,8,4,4,5,21,35
"2722","Afghanistan","Asia","c",2009,"NF",5,6,6,7,3,0,"0",16,5,4,2,5,16,32
"2723","Albania","Europe","c",2009,"PF",3,3,8,11,7,0,"0",26,13,8,10,9,40,66
"2724","Algeria","Africa","c",2009,"NF",6,5,4,4,3,0,"0",11,7,6,5,7,25,36
"2725","Andorra","Europe","c",2009,"F",1,1,12,15,12,0,"0",39,16,11,15,15,57,96
"2726","Angola","Africa","c",2009,"NF",6,5,4,6,1,0,"0",11,8,6,4,3,21,32
"2727","Antigua and Barbuda","Americas","c",2009,"F",2,2,11,12,7,0,"0",30,13,9,12,13,47,77
"2728","Argentina","Americas","c",2009,"F",2,2,11,15,6,0,"0",32,14,11,10,13,48,80
"2729","Armenia","Eurasia","c",2009,"PF",6,4,4,4,3,0,"0",11,8,5,5,9,27,38
"2730","Australia","Asia","c",2009,"F",1,1,12,15,12,0,"0",39,16,12,14,15,57,96
"2731","Austria","Europe","c",2009,"F",1,1,12,15,12,0,"0",39,16,12,15,15,58,97
"2732","Azerbaijan","Eurasia","c",2009,"NF",6,5,2,3,3,0,"0",8,6,3,4,8,21,29
"2733","Bahamas","Americas","c",2009,"F",1,1,12,16,10,0,"0",38,16,12,15,15,58,96
"2734","Bahrain","Middle East","c",2009,"PF",5,5,3,8,4,2,"0",13,8,3,3,7,21,34
"2735","Bangladesh","Asia","c",2009,"PF",4,4,9,9,4,0,"0",22,8,8,5,9,30,52
"2736","Barbados","Americas","c",2009,"F",1,1,12,16,12,0,"0",40,16,12,16,15,59,99
"2737","Belarus","Eurasia","c",2009,"NF",7,6,0,3,1,0,"0",4,3,1,2,5,11,15
"2738","Belgium","Europe","c",2009,"F",1,1,12,16,11,0,"0",39,16,12,15,15,58,97
"2739","Belize","Americas","c",2009,"F",1,2,12,14,10,0,"0",36,15,11,12,13,51,87
"2740","Benin","Africa","c",2009,"F",2,2,9,15,8,0,"0",32,15,12,11,10,48,80
"2741","Bhutan","Asia","c",2009,"PF",4,5,7,7,6,1,"0",19,8,3,5,8,24,43
"2742","Bolivia","Americas","c",2009,"PF",3,3,11,12,5,0,"0",28,14,10,7,9,40,68
"2743","Bosnia and Herzegovina","Europe","c",2009,"PF",4,3,8,10,5,0,"0",23,11,7,10,10,38,61
"2744","Botswana","Africa","c",2009,"F",2,2,10,11,9,0,"0",30,14,10,13,11,48,78
"2745","Brazil","Americas","c",2009,"F",2,2,11,14,7,0,"0",32,15,10,8,12,45,77
"2746","Brunei","Asia","c",2009,"NF",6,5,0,3,3,0,"1",7,6,3,6,8,23,30
"2747","Bulgaria","Europe","c",2009,"F",2,2,12,15,8,0,"0",35,14,11,11,11,47,82
"2748","Burkina Faso","Africa","c",2009,"PF",5,3,5,8,4,0,"0",17,13,8,6,8,35,52
"2749","Burundi","Africa","c",2009,"PF",4,5,8,8,4,0,"0",20,8,5,4,6,23,43
"2750","Cambodia","Asia","c",2009,"NF",6,5,3,5,3,0,"0",11,10,5,2,6,23,34
"2751","Cameroon","Africa","c",2009,"NF",6,6,2,3,3,0,"0",8,7,2,2,4,15,23
"2752","Canada","Americas","c",2009,"F",1,1,12,16,11,0,"0",39,15,12,15,16,58,97
"2753","Cape Verde","Africa","c",2009,"F",1,1,12,15,10,0,"0",37,15,11,14,13,53,90
"2754","Central African Republic","Africa","c",2009,"PF",5,5,7,7,3,0,"0",17,10,6,3,4,23,40
"2755","Chad","Africa","c",2009,"NF",7,6,3,1,1,0,"0",5,7,4,1,3,15,20
"2756","Chechnya","Eurasia","t",2009,"NF",7,7,0,0,0,0,"0",0,4,0,0,3,7,7
"2757","Chile","Americas","c",2009,"F",1,1,12,15,12,0,"0",39,16,12,15,15,58,97
"2758","China","Asia","c",2009,"NF",7,6,0,1,1,0,"0",2,3,2,2,7,14,16
"2759","Colombia","Americas","c",2009,"PF",3,4,10,9,7,0,"0",26,12,5,7,10,34,60
"2760","Comoros","Africa","c",2009,"PF",3,4,9,11,5,0,"0",25,10,6,8,6,30,55
"2761","Congo (Brazzaville)","Africa","c",2009,"NF",6,5,2,4,3,0,"0",9,9,7,2,6,24,33
"2762","Congo (Kinshasa)","Africa","c",2009,"NF",6,6,6,3,2,0,"0",11,6,4,0,1,11,22
"2763","Costa Rica","Americas","c",2009,"F",1,1,12,15,11,0,"0",38,16,11,13,13,53,91
"2764","Cote d'Ivoire","Africa","c",2009,"NF",6,5,1,3,2,0,"0",6,5,4,5,5,19,25
"2765","Croatia","Europe","c",2009,"F",2,2,12,14,9,0,"0",35,14,12,10,13,49,84
"2766","Cuba","Americas","c",2009,"NF",7,6,0,0,1,0,"0",1,2,1,2,3,8,9
"2767","Cyprus","Europe","c",2009,"F",1,1,11,16,11,0,"0",38,15,12,15,15,57,95
"2768","Czech Republic","Europe","c",2009,"F",1,1,12,15,11,0,"0",38,16,12,14,15,57,95
"2769","Denmark","Europe","c",2009,"F",1,1,12,16,12,0,"0",40,16,12,14,15,57,97
"2770","Djibouti","Africa","c",2009,"PF",5,5,4,5,3,0,"0",12,6,5,5,6,22,34
"2771","Dominica","Americas","c",2009,"F",1,1,12,16,11,0,"0",39,16,12,15,15,58,97
"2772","Dominican Republic","Americas","c",2009,"F",2,2,11,13,9,0,"0",33,15,11,10,12,48,81
"2773","Ecuador","Americas","c",2009,"PF",3,3,9,14,6,0,"0",29,14,10,6,10,40,69
"2774","Egypt","Africa","c",2009,"NF",6,5,1,4,2,0,"0",7,5,2,4,7,18,25
"2775","El Salvador","Americas","c",2009,"F",2,3,12,13,8,0,"0",33,15,8,7,10,40,73
"2776","Equatorial Guinea","Africa","c",2009,"NF",7,7,0,1,0,0,"0",1,4,0,0,3,7,8
"2777","Eritrea","Africa","c",2009,"NF",7,6,0,1,2,0,"0",3,2,0,2,6,10,13
"2778","Estonia","Europe","c",2009,"F",1,1,12,15,12,0,"0",39,16,12,14,14,56,95
"2779","Ethiopia","Africa","c",2009,"PF",5,5,5,4,4,0,"0",13,7,3,4,6,20,33
"2780","Fiji","Asia","c",2009,"PF",6,4,0,5,2,0,"0",7,10,4,7,10,31,38
"2781","Finland","Europe","c",2009,"F",1,1,12,16,12,0,"0",40,16,12,16,16,60,100
"2782","France","Europe","c",2009,"F",1,1,12,15,11,0,"0",38,16,12,15,15,58,96
"2783","Gabon","Africa","c",2009,"PF",6,4,2,5,3,0,"0",10,10,5,6,5,26,36
"2784","Georgia","Eurasia","c",2009,"PF",4,4,6,6,6,0,"0",18,11,7,5,10,33,51
"2785","Germany","Europe","c",2009,"F",1,1,12,15,12,0,"0",39,15,12,15,15,57,96
"2786","Ghana","Africa","c",2009,"F",1,2,12,15,10,0,"0",37,14,11,12,10,47,84
"2787","Greece","Europe","c",2009,"F",1,2,12,15,10,0,"0",37,14,12,12,13,51,88
"2788","Grenada","Americas","c",2009,"F",1,2,12,16,10,0,"0",38,15,10,12,15,52,90
"2789","Guatemala","Americas","c",2009,"PF",3,4,9,10,5,0,"0",24,12,8,5,8,33,57
"2790","Guinea","Africa","c",2009,"NF",7,5,1,3,1,0,"0",5,8,5,4,6,23,28
"2791","Guinea-Bissau","Africa","c",2009,"PF",4,4,9,9,3,0,"0",21,10,8,6,5,29,50
"2792","Guyana","Americas","c",2009,"F",2,3,11,13,7,0,"0",31,15,10,8,9,42,73
"2793","Haiti","Americas","c",2009,"PF",4,5,7,10,5,0,"0",22,10,6,4,5,25,47
"2794","Honduras","Americas","c",2009,"PF",3,3,9,10,6,0,"0",25,12,7,7,9,35,60
"2795","Hong Kong","Asia","t",2009,"PF",5,2,3,7,6,0,"0",16,14,10,15,13,52,68
"2796","Hungary","Europe","c",2009,"F",1,1,12,15,10,0,"0",37,16,12,13,14,55,92
"2797","Iceland","Europe","c",2009,"F",1,1,12,16,12,0,"0",40,16,12,16,16,60,100
"2798","India","Asia","c",2009,"F",2,3,11,14,9,0,"0",34,13,10,9,10,42,76
"2799","Indian Kashmir","Asia","t",2009,"PF",5,4,6,8,3,0,"0",17,8,6,4,8,26,43
"2800","Indonesia","Asia","c",2009,"F",2,3,11,13,6,0,"0",30,11,9,7,9,36,66
"2801","Iran","Middle East","c",2009,"NF",6,6,3,3,3,0,"0",9,4,2,3,4,13,22
"2802","Iraq","Middle East","c",2009,"NF",6,6,7,5,1,2,"0",11,5,3,1,4,13,24
"2803","Ireland","Europe","c",2009,"F",1,1,12,16,11,0,"0",39,16,12,15,15,58,97
"2804","Israel","Middle East","c",2009,"F",1,2,12,15,10,0,"0",37,13,12,11,11,47,84
"2805","Israeli Occupied Territories","Middle East","t",2009,"NF",6,6,3,2,3,2,"0",6,6,5,1,3,15,21
"2806","Italy","Europe","c",2009,"F",1,2,12,15,11,0,"0",38,14,12,12,14,52,90
"2807","Jamaica","Americas","c",2009,"F",2,3,12,14,8,0,"0",34,15,9,7,10,41,75
"2808","Japan","Asia","c",2009,"F",1,2,12,15,10,0,"0",37,13,10,15,13,51,88
"2809","Jordan","Middle East","c",2009,"PF",5,5,2,6,5,0,"0",13,7,4,6,8,25,38
"2810","Kazakhstan","Eurasia","c",2009,"NF",6,5,2,3,2,0,"0",7,7,4,4,8,23,30
"2811","Kenya","Africa","c",2009,"PF",4,3,6,9,4,0,"0",19,13,9,7,6,35,54
"2812","Kiribati","Asia","c",2009,"F",1,1,12,16,8,0,"0",36,15,12,15,13,55,91
"2813","Kosovo","Europe","t",2009,"NF",6,5,6,5,3,3,"0",11,7,6,4,7,24,35
"2814","Kuwait","Middle East","c",2009,"PF",4,4,4,9,6,0,"0",19,9,6,7,5,27,46
"2815","Kyrgyzstan","Eurasia","c",2009,"PF",5,4,4,5,4,0,"0",13,9,5,5,7,26,39
"2816","Laos","Asia","c",2009,"NF",7,6,0,1,0,0,"0",1,4,1,2,5,12,13
"2817","Latvia","Europe","c",2009,"F",2,1,12,15,7,0,"0",34,16,12,12,13,53,87
"2818","Lebanon","Middle East","c",2009,"PF",5,4,5,8,4,0,"0",17,12,8,5,9,34,51
"2819","Lesotho","Africa","c",2009,"F",2,3,9,12,9,0,"0",30,14,7,11,9,41,71
"2820","Liberia","Africa","c",2009,"PF",3,4,9,10,6,0,"0",25,11,8,7,8,34,59
"2821","Libya","Africa","c",2009,"NF",7,7,0,1,0,0,"0",1,1,0,0,6,7,8
"2822","Liechtenstein","Europe","c",2009,"F",1,1,12,16,12,0,"0",40,16,12,16,16,60,100
"2823","Lithuania","Europe","c",2009,"F",1,1,12,16,9,0,"0",37,16,11,14,13,54,91
"2824","Luxembourg","Europe","c",2009,"F",1,1,12,16,12,0,"0",40,16,12,16,16,60,100
"2825","Macedonia","Europe","c",2009,"PF",3,3,7,10,7,0,"0",24,11,7,8,10,36,60
"2826","Madagascar","Africa","c",2009,"PF",4,3,7,8,7,0,"0",22,10,8,9,9,36,58
"2827","Malawi","Africa","c",2009,"PF",4,4,7,10,6,0,"0",23,11,8,8,7,34,57
"2828","Malaysia","Asia","c",2009,"PF",4,4,6,8,6,0,"0",20,9,6,6,8,29,49
"2829","Maldives","Asia","c",2009,"PF",4,4,6,9,5,0,"0",20,8,6,7,7,28,48
"2830","Mali","Africa","c",2009,"F",2,3,9,12,9,0,"0",30,16,9,7,8,40,70
"2831","Malta","Europe","c",2009,"F",1,1,12,16,11,0,"0",39,16,12,16,15,59,98
"2832","Marshall Islands","Asia","c",2009,"F",1,1,11,15,10,0,"0",36,16,11,15,13,55,91
"2833","Mauritania","Africa","c",2009,"NF",6,5,2,3,4,0,"0",9,9,5,4,5,23,32
"2834","Mauritius","Africa","c",2009,"F",1,2,12,15,11,0,"0",38,15,12,13,12,52,90
"2835","Mexico","Americas","c",2009,"F",2,3,10,13,8,0,"0",31,14,8,6,11,39,70
"2836","Micronesia","Asia","c",2009,"F",1,1,12,15,10,0,"0",37,16,11,15,14,56,93
"2837","Moldova","Eurasia","c",2009,"PF",4,4,9,8,5,0,"0",22,10,6,8,9,33,55
"2838","Monaco","Europe","c",2009,"F",2,1,10,11,10,0,"0",31,15,12,15,14,56,87
"2839","Mongolia","Asia","c",2009,"F",2,2,9,15,10,0,"0",34,15,9,12,12,48,82
"2840","Montenegro","Europe","c",2009,"PF",3,3,9,9,6,0,"0",24,13,10,8,11,42,66
"2841","Morocco","Africa","c",2009,"PF",5,4,4,7,5,0,"0",16,8,6,6,8,28,44
"2842","Mozambique","Africa","c",2009,"PF",3,3,7,11,7,0,"0",25,12,7,8,9,36,61
"2843","Myanmar","Asia","c",2009,"NF",7,7,0,0,0,3,"0",-3,2,0,0,3,5,2
"2844","Nagorno-Karabakh","Eurasia","t",2009,"PF",5,5,6,5,3,0,"0",14,7,3,5,5,20,34
"2845","Namibia","Africa","c",2009,"F",2,2,10,11,9,0,"0",30,15,11,10,9,45,75
"2846","Nauru","Asia","c",2009,"F",1,1,12,16,10,0,"0",38,15,11,15,14,55,93
"2847","Nepal","Asia","c",2009,"PF",4,4,6,11,4,0,"0",21,10,6,6,7,29,50
"2848","Netherlands","Europe","c",2009,"F",1,1,12,16,12,0,"0",40,16,12,15,16,59,99
"2849","New Zealand","Asia","c",2009,"F",1,1,12,15,12,0,"0",39,16,11,15,15,57,96
"2850","Nicaragua","Americas","c",2009,"PF",4,3,9,9,4,0,"0",22,12,6,8,9,35,57
"2851","Niger","Africa","c",2009,"PF",3,4,11,9,8,0,"0",28,10,8,6,6,30,58
"2852","Nigeria","Africa","c",2009,"PF",5,4,3,8,6,0,"0",17,10,8,5,7,30,47
"2853","North Korea","Asia","c",2009,"NF",7,7,0,0,0,0,"0",0,0,0,0,2,2,2
"2854","Northern Cyprus","Europe","t",2009,"F",2,2,11,14,9,0,"0",34,14,9,12,12,47,81
"2855","Norway","Europe","c",2009,"F",1,1,12,16,12,0,"0",40,16,12,16,16,60,100
"2856","Oman","Middle East","c",2009,"NF",6,5,2,2,2,0,"4",10,6,3,4,5,18,28
"2857","Pakistan","Asia","c",2009,"PF",4,5,6,8,4,0,"0",18,7,7,2,6,22,40
"2858","Pakistani Kashmir","Asia","t",2009,"NF",6,5,2,3,3,2,"0",6,6,5,4,6,21,27
"2859","Palau","Asia","c",2009,"F",1,1,12,15,10,0,"0",37,16,11,15,13,55,92
"2860","Palestinian Authority Administered Territories","Middle East","t",2009,"NF",5,6,4,5,3,0,"0",12,5,3,1,4,13,25
"2861","Panama","Americas","c",2009,"F",1,2,12,15,9,0,"0",36,15,11,9,12,47,83
"2862","Papua New Guinea","Asia","c",2009,"PF",4,3,9,10,4,0,"0",23,12,9,7,8,36,59
"2863","Paraguay","Americas","c",2009,"PF",3,3,11,12,5,0,"0",28,12,8,6,10,36,64
"2864","Peru","Americas","c",2009,"F",2,3,11,14,7,0,"0",32,15,8,8,10,41,73
"2865","Philippines","Asia","c",2009,"PF",4,3,6,10,6,0,"0",22,14,8,6,10,38,60
"2866","Poland","Europe","c",2009,"F",1,1,12,16,10,0,"0",38,16,12,13,14,55,93
"2867","Portugal","Europe","c",2009,"F",1,1,12,16,11,0,"0",39,16,12,15,15,58,97
"2868","Puerto Rico","Americas","t",2009,"F",1,1,12,15,10,0,"0",37,16,11,14,14,55,92
"2869","Qatar","Middle East","c",2009,"NF",6,5,2,2,3,0,"3",10,8,2,4,4,18,28
"2870","Romania","Europe","c",2009,"F",2,2,12,14,8,0,"0",34,14,11,12,12,49,83
"2871","Russia","Eurasia","c",2009,"NF",6,5,2,3,3,0,"0",8,8,4,4,7,23,31
"2872","Rwanda","Africa","c",2009,"NF",6,5,3,4,4,0,"0",11,7,3,6,7,23,34
"2873","Samoa","Asia","c",2009,"F",2,2,9,13,10,0,"0",32,14,10,13,12,49,81
"2874","San Marino","Europe","c",2009,"F",1,1,12,16,12,0,"0",40,16,12,16,16,60,100
"2875","Sao Tome and Principe","Africa","c",2009,"F",2,2,11,14,8,0,"0",33,15,10,12,10,47,80
"2876","Saudi Arabia","Middle East","c",2009,"NF",7,6,0,0,1,0,"2",3,4,0,3,2,9,12
"2877","Senegal","Africa","c",2009,"PF",3,3,9,11,9,0,"0",29,14,10,10,9,43,72
"2878","Serbia","Europe","c",2009,"F",3,2,9,13,7,0,"0",29,14,11,9,13,47,76
"2879","Seychelles","Africa","c",2009,"PF",3,3,8,10,7,0,"0",25,11,9,11,11,42,67
"2880","Sierra Leone","Africa","c",2009,"PF",3,3,10,12,5,0,"0",27,12,8,8,9,37,64
"2881","Singapore","Asia","c",2009,"PF",5,4,4,6,7,0,"0",17,9,3,7,12,31,48
"2882","Slovakia","Europe","c",2009,"F",1,1,12,15,10,0,"0",37,16,12,12,14,54,91
"2883","Slovenia","Europe","c",2009,"F",1,1,12,15,11,0,"0",38,14,12,14,13,53,91
"2884","Solomon Islands","Asia","c",2009,"PF",4,3,6,10,6,0,"0",22,13,9,8,12,42,64
"2885","Somalia","Africa","c",2009,"NF",7,7,0,0,0,0,"0",0,2,0,0,0,2,2
"2886","Somaliland","Africa","t",2009,"PF",5,4,5,7,5,0,"0",17,8,6,7,6,27,44
"2887","South Africa","Africa","c",2009,"F",2,2,12,14,9,0,"0",35,15,12,11,12,50,85
"2888","South Korea","Asia","c",2009,"F",1,2,11,15,10,0,"0",36,14,11,13,12,50,86
"2889","South Ossetia","Eurasia","t",2009,"NF",7,6,1,0,0,3,"0",-2,4,1,1,5,11,9
"2890","Spain","Europe","c",2009,"F",1,1,12,16,12,0,"0",40,16,12,14,15,57,97
"2891","Sri Lanka","Asia","c",2009,"PF",4,4,8,7,6,0,"0",21,8,8,6,9,31,52
"2892","St. Kitts and Nevis","Americas","c",2009,"F",1,1,12,16,11,0,"0",39,15,12,12,14,53,92
"2893","St. Lucia","Americas","c",2009,"F",1,1,12,16,11,0,"0",39,15,12,12,14,53,92
"2894","St. Vincent and the Grenadines","Americas","c",2009,"F",2,1,11,15,9,0,"0",35,15,11,13,14,53,88
"2895","Sudan","Africa","c",2009,"NF",7,7,0,4,3,4,"0",3,4,3,0,0,7,10
"2896","Suriname","Americas","c",2009,"F",2,2,12,13,8,0,"0",33,15,11,9,10,45,78
"2897","Swaziland","Africa","c",2009,"NF",7,5,0,1,1,0,"1",3,8,3,4,5,20,23
"2898","Sweden","Europe","c",2009,"F",1,1,12,16,12,0,"0",40,16,12,16,16,60,100
"2899","Switzerland","Europe","c",2009,"F",1,1,12,15,12,0,"0",39,16,12,15,15,58,97
"2900","Syria","Middle East","c",2009,"NF",7,6,0,0,1,0,"0",1,2,0,1,5,8,9
"2901","Taiwan","Asia","c",2009,"F",2,1,11,15,9,0,"0",35,16,10,15,13,54,89
"2902","Tajikistan","Eurasia","c",2009,"NF",6,5,2,4,2,0,"0",8,6,4,4,5,19,27
"2903","Tanzania","Africa","c",2009,"PF",4,3,6,10,6,0,"0",22,11,7,10,8,36,58
"2904","Thailand","Asia","c",2009,"PF",5,4,3,5,4,0,"0",12,9,6,6,11,32,44
"2905","The Gambia","Africa","c",2009,"PF",5,4,6,7,3,0,"0",16,8,6,6,7,27,43
"2906","Tibet","Asia","t",2009,"NF",7,7,0,0,1,3,"0",-2,0,0,0,3,3,1
"2907","Timor-Leste","Asia","c",2009,"PF",3,4,11,11,6,0,"0",28,12,7,6,9,34,62
"2908","Togo","Africa","c",2009,"PF",5,5,4,7,3,0,"0",14,8,6,5,6,25,39
"2909","Tonga","Asia","c",2009,"PF",5,3,3,9,3,0,"0",15,12,5,11,12,40,55
"2910","Transnistria","Eurasia","t",2009,"NF",6,6,2,4,1,0,"0",7,6,2,2,5,15,22
"2911","Trinidad and Tobago","Americas","c",2009,"F",2,2,11,12,9,0,"0",32,15,11,10,13,49,81
"2912","Tunisia","Africa","c",2009,"NF",7,5,1,3,1,0,"0",5,4,2,4,8,18,23
"2913","Turkey","Europe","c",2009,"PF",3,3,10,12,7,0,"0",29,11,7,8,10,36,65
"2914","Turkmenistan","Eurasia","c",2009,"NF",7,7,0,1,0,0,"0",1,2,0,1,2,5,6
"2915","Tuvalu","Asia","c",2009,"F",1,1,12,15,10,0,"0",37,16,12,15,14,57,94
"2916","Uganda","Africa","c",2009,"PF",5,4,4,7,4,0,"0",15,11,6,6,7,30,45
"2917","Ukraine","Eurasia","c",2009,"F",3,2,10,13,5,0,"0",28,13,11,10,11,45,73
"2918","United Arab Emirates","Middle East","c",2009,"NF",6,5,1,2,2,0,"4",9,8,3,4,4,19,28
"2919","United Kingdom","Europe","c",2009,"F",1,1,12,16,12,0,"0",40,16,12,14,15,57,97
"2920","United States","Americas","c",2009,"F",1,1,11,16,11,0,"0",38,16,11,14,15,56,94
"2921","Uruguay","Americas","c",2009,"F",1,1,12,16,11,0,"0",39,16,12,15,15,58,97
"2922","Uzbekistan","Eurasia","c",2009,"NF",7,7,0,0,0,0,"0",0,1,0,0,2,3,3
"2923","Vanuatu","Asia","c",2009,"F",2,2,9,15,8,0,"0",32,16,11,10,11,48,80
"2924","Venezuela","Americas","c",2009,"PF",4,4,7,8,3,0,"0",18,9,6,5,8,28,46
"2925","Vietnam","Asia","c",2009,"NF",7,5,0,1,1,0,"0",2,6,2,4,8,20,22
"2926","Western Sahara","Africa","t",2009,"NF",7,6,0,0,0,2,"0",-2,3,3,0,5,11,9
"2927","Yemen","Middle East","c",2009,"PF",5,5,5,7,3,0,"0",15,7,4,4,5,20,35
"2928","Zambia","Africa","c",2009,"PF",3,3,8,12,6,0,"0",26,11,8,9,7,35,61
"2929","Zimbabwe","Africa","c",2009,"NF",7,6,1,3,0,0,"0",4,4,2,1,1,8,12
"2930","Abkhazia","Eurasia","t",2008,"PF",5,5,5,6,4,0,"0",15,8,4,4,5,21,36
"2931","Afghanistan","Asia","c",2008,"PF",5,5,6,7,4,0,"0",17,5,4,3,5,17,34
"2932","Albania","Europe","c",2008,"PF",3,3,8,11,7,0,"0",26,12,8,10,9,39,65
"2933","Algeria","Africa","c",2008,"NF",6,5,4,4,3,0,"0",11,7,6,5,7,25,36
"2934","Andorra","Europe","c",2008,"F",1,1,12,15,12,0,"0",39,16,11,15,15,57,96
"2935","Angola","Africa","c",2008,"NF",6,5,2,5,1,0,"0",8,8,6,4,3,21,29
"2936","Antigua and Barbuda","Americas","c",2008,"F",2,2,11,12,7,0,"0",30,13,9,12,13,47,77
"2937","Argentina","Americas","c",2008,"F",2,2,11,15,6,0,"0",32,14,11,10,13,48,80
"2938","Armenia","Eurasia","c",2008,"PF",5,4,5,5,4,0,"0",14,8,5,6,9,28,42
"2939","Australia","Asia","c",2008,"F",1,1,12,15,12,0,"0",39,16,12,14,15,57,96
"2940","Austria","Europe","c",2008,"F",1,1,12,16,12,0,"0",40,16,12,15,15,58,98
"2941","Azerbaijan","Eurasia","c",2008,"NF",6,5,3,4,3,0,"0",10,6,3,4,8,21,31
"2942","Bahamas","Americas","c",2008,"F",1,1,12,16,10,0,"0",38,16,12,15,15,58,96
"2943","Bahrain","Middle East","c",2008,"PF",5,5,3,8,4,0,"0",15,9,3,3,7,22,37
"2944","Bangladesh","Asia","c",2008,"PF",5,4,3,5,4,0,"0",12,7,6,6,9,28,40
"2945","Barbados","Americas","c",2008,"F",1,1,12,16,12,0,"0",40,16,12,16,15,59,99
"2946","Belarus","Eurasia","c",2008,"NF",7,6,0,2,1,0,"0",3,3,0,2,5,10,13
"2947","Belgium","Europe","c",2008,"F",1,1,12,16,11,0,"0",39,16,12,15,15,58,97
"2948","Belize","Americas","c",2008,"F",1,2,12,14,10,0,"0",36,15,11,12,13,51,87
"2949","Benin","Africa","c",2008,"F",2,2,10,15,8,0,"0",33,15,12,12,10,49,82
"2950","Bhutan","Asia","c",2008,"NF",6,5,3,4,5,1,"0",11,7,3,5,8,23,34
"2951","Bolivia","Americas","c",2008,"PF",3,3,11,13,5,0,"0",29,15,10,7,9,41,70
"2952","Bosnia and Herzegovina","Europe","c",2008,"PF",4,3,8,10,5,0,"0",23,11,8,10,10,39,62
"2953","Botswana","Africa","c",2008,"F",2,2,11,11,9,0,"0",31,14,10,13,11,48,79
"2954","Brazil","Americas","c",2008,"F",2,2,11,14,6,0,"0",31,15,10,8,12,45,76
"2955","Brunei","Asia","c",2008,"NF",6,5,0,3,3,0,"1",7,6,3,6,8,23,30
"2956","Bulgaria","Europe","c",2008,"F",1,2,12,15,9,0,"0",36,14,11,12,12,49,85
"2957","Burkina Faso","Africa","c",2008,"PF",5,3,5,8,4,0,"0",17,13,9,6,8,36,53
"2958","Burundi","Africa","c",2008,"PF",4,5,9,9,4,0,"0",22,8,5,4,6,23,45
"2959","Cambodia","Asia","c",2008,"NF",6,5,3,5,3,0,"0",11,10,6,2,6,24,35
"2960","Cameroon","Africa","c",2008,"NF",6,6,2,4,3,0,"0",9,7,3,2,4,16,25
"2961","Canada","Americas","c",2008,"F",1,1,12,16,12,0,"0",40,16,12,15,16,59,99
"2962","Cape Verde","Africa","c",2008,"F",1,1,12,15,10,0,"0",37,15,11,14,13,53,90
"2963","Central African Republic","Africa","c",2008,"PF",5,5,7,7,3,0,"0",17,10,6,3,4,23,40
"2964","Chad","Africa","c",2008,"NF",7,6,3,1,1,0,"0",5,7,4,1,3,15,20
"2965","Chechnya","Eurasia","t",2008,"NF",7,7,0,0,0,0,"0",0,4,0,0,3,7,7
"2966","Chile","Americas","c",2008,"F",1,1,12,15,12,0,"0",39,16,12,15,15,58,97
"2967","China","Asia","c",2008,"NF",7,6,0,1,1,0,"0",2,4,2,2,8,16,18
"2968","Colombia","Americas","c",2008,"PF",3,3,10,9,7,0,"0",26,12,6,7,10,35,61
"2969","Comoros","Africa","c",2008,"PF",4,4,8,11,4,0,"0",23,10,6,8,6,30,53
"2970","Congo (Brazzaville)","Africa","c",2008,"NF",6,5,1,4,3,0,"0",8,9,7,2,6,24,32
"2971","Congo (Kinshasa)","Africa","c",2008,"NF",5,6,6,5,2,0,"0",13,6,5,0,1,12,25
"2972","Costa Rica","Americas","c",2008,"F",1,1,12,15,11,0,"0",38,16,11,13,13,53,91
"2973","Cote d'Ivoire","Africa","c",2008,"NF",7,5,1,2,2,0,"0",5,5,4,5,5,19,24
"2974","Croatia","Europe","c",2008,"F",2,2,12,14,9,0,"0",35,14,12,11,13,50,85
"2975","Cuba","Americas","c",2008,"NF",7,7,0,0,1,0,"0",1,2,1,1,2,6,7
"2976","Cyprus","Europe","c",2008,"F",1,1,11,16,11,0,"0",38,15,12,15,15,57,95
"2977","Czech Republic","Europe","c",2008,"F",1,1,12,15,11,0,"0",38,16,12,14,15,57,95
"2978","Denmark","Europe","c",2008,"F",1,1,12,16,12,0,"0",40,16,12,15,15,58,98
"2979","Djibouti","Africa","c",2008,"PF",5,5,4,5,3,0,"0",12,6,5,5,6,22,34
"2980","Dominica","Americas","c",2008,"F",1,1,12,16,11,0,"0",39,16,12,15,15,58,97
"2981","Dominican Republic","Americas","c",2008,"F",2,2,11,13,9,0,"0",33,15,11,10,11,47,80
"2982","Ecuador","Americas","c",2008,"PF",3,3,9,14,4,0,"0",27,15,11,6,10,42,69
"2983","Egypt","Africa","c",2008,"NF",6,5,1,4,2,0,"0",7,5,2,4,7,18,25
"2984","El Salvador","Americas","c",2008,"F",2,3,12,13,8,0,"0",33,15,8,7,10,40,73
"2985","Equatorial Guinea","Africa","c",2008,"NF",7,6,0,1,0,0,"0",1,5,0,1,3,9,10
"2986","Eritrea","Africa","c",2008,"NF",7,6,0,1,2,0,"0",3,2,0,2,6,10,13
"2987","Estonia","Europe","c",2008,"F",1,1,12,14,12,0,"0",38,16,12,14,14,56,94
"2988","Ethiopia","Africa","c",2008,"PF",5,5,5,4,4,0,"0",13,7,3,4,6,20,33
"2989","Fiji","Asia","c",2008,"PF",6,4,0,5,2,0,"0",7,11,4,7,10,32,39
"2990","Finland","Europe","c",2008,"F",1,1,12,16,12,0,"0",40,16,12,16,16,60,100
"2991","France","Europe","c",2008,"F",1,1,12,15,11,0,"0",38,15,12,13,15,55,93
"2992","Gabon","Africa","c",2008,"PF",6,4,2,5,3,0,"0",10,10,6,6,5,27,37
"2993","Georgia","Eurasia","c",2008,"PF",4,4,8,6,6,0,"0",20,11,7,6,10,34,54
"2994","Germany","Europe","c",2008,"F",1,1,12,15,12,0,"0",39,15,12,15,15,57,96
"2995","Ghana","Africa","c",2008,"F",1,2,12,15,10,0,"0",37,14,11,12,10,47,84
"2996","Greece","Europe","c",2008,"F",1,2,12,15,10,0,"0",37,15,11,13,13,52,89
"2997","Grenada","Americas","c",2008,"F",1,2,12,16,9,0,"0",37,15,9,12,15,51,88
"2998","Guatemala","Americas","c",2008,"PF",3,4,9,10,5,0,"0",24,12,8,5,8,33,57
"2999","Guinea","Africa","c",2008,"NF",6,5,2,5,3,0,"0",10,8,5,4,6,23,33
"3000","Guinea-Bissau","Africa","c",2008,"PF",4,4,9,9,3,0,"0",21,10,8,6,6,30,51
"3001","Guyana","Americas","c",2008,"F",2,3,11,13,7,0,"0",31,15,10,8,9,42,73
"3002","Haiti","Americas","c",2008,"PF",4,5,7,10,5,0,"0",22,10,6,4,5,25,47
"3003","Honduras","Americas","c",2008,"PF",3,3,9,10,6,0,"0",25,12,8,7,9,36,61
"3004","Hong Kong","Asia","t",2008,"PF",5,2,3,7,6,0,"0",16,14,10,14,13,51,67
"3005","Hungary","Europe","c",2008,"F",1,1,12,15,10,0,"0",37,16,12,13,14,55,92
"3006","Iceland","Europe","c",2008,"F",1,1,12,16,12,0,"0",40,16,12,16,16,60,100
"3007","India","Asia","c",2008,"F",2,3,11,14,9,0,"0",34,13,10,9,10,42,76
"3008","Indian Kashmir","Asia","t",2008,"PF",5,4,6,6,3,0,"0",15,8,6,4,8,26,41
"3009","Indonesia","Asia","c",2008,"F",2,3,11,13,6,0,"0",30,12,9,7,9,37,67
"3010","Iran","Middle East","c",2008,"NF",6,6,3,4,3,0,"0",10,5,2,3,4,14,24
"3011","Iraq","Middle East","c",2008,"NF",6,6,7,6,1,3,"0",11,5,3,0,4,12,23
"3012","Ireland","Europe","c",2008,"F",1,1,12,16,11,0,"0",39,16,12,15,15,58,97
"3013","Israel","Middle East","c",2008,"F",1,2,12,15,10,0,"0",37,14,12,10,11,47,84
"3014","Israeli Occupied Territories","Middle East","t",2008,"NF",6,6,3,2,3,1,"0",7,6,5,1,4,16,23
"3015","Italy","Europe","c",2008,"F",1,1,12,15,11,0,"0",38,15,12,12,15,54,92
"3016","Jamaica","Americas","c",2008,"F",2,3,12,14,8,0,"0",34,15,9,8,11,43,77
"3017","Japan","Asia","c",2008,"F",1,2,12,15,10,0,"0",37,13,10,15,13,51,88
"3018","Jordan","Middle East","c",2008,"PF",5,4,2,6,5,0,"0",13,9,5,6,8,28,41
"3019","Kazakhstan","Eurasia","c",2008,"NF",6,5,3,3,2,0,"0",8,7,4,4,7,22,30
"3020","Kenya","Africa","c",2008,"PF",4,3,6,9,5,0,"0",20,14,9,7,8,38,58
"3021","Kiribati","Asia","c",2008,"F",1,1,12,16,8,0,"0",36,15,12,15,13,55,91
"3022","Kosovo","Europe","t",2008,"NF",6,5,6,5,3,3,"0",11,7,6,4,6,23,34
"3023","Kuwait","Middle East","c",2008,"PF",4,4,4,9,6,0,"0",19,9,6,7,5,27,46
"3024","Kyrgyzstan","Eurasia","c",2008,"PF",5,4,5,7,4,0,"0",16,10,7,5,7,29,45
"3025","Laos","Asia","c",2008,"NF",7,6,0,1,0,0,"0",1,4,1,2,5,12,13
"3026","Latvia","Europe","c",2008,"F",2,1,12,15,8,0,"0",35,16,12,12,13,53,88
"3027","Lebanon","Middle East","c",2008,"PF",5,4,4,7,4,0,"0",15,12,8,5,9,34,49
"3028","Lesotho","Africa","c",2008,"F",2,3,9,12,9,0,"0",30,14,7,11,9,41,71
"3029","Liberia","Africa","c",2008,"PF",3,4,9,10,6,0,"0",25,11,8,7,8,34,59
"3030","Libya","Africa","c",2008,"NF",7,7,0,1,0,0,"0",1,1,0,0,6,7,8
"3031","Liechtenstein","Europe","c",2008,"F",1,1,12,16,12,0,"0",40,16,12,16,16,60,100
"3032","Lithuania","Europe","c",2008,"F",1,1,12,15,9,0,"0",36,16,11,14,13,54,90
"3033","Luxembourg","Europe","c",2008,"F",1,1,12,16,12,0,"0",40,16,12,16,16,60,100
"3034","Macedonia","Europe","c",2008,"PF",3,3,7,10,7,0,"0",24,11,7,8,10,36,60
"3035","Madagascar","Africa","c",2008,"PF",4,3,7,8,7,0,"0",22,10,8,9,9,36,58
"3036","Malawi","Africa","c",2008,"PF",4,4,7,10,6,0,"0",23,11,8,8,7,34,57
"3037","Malaysia","Asia","c",2008,"PF",4,4,6,7,6,0,"0",19,8,5,6,8,27,46
"3038","Maldives","Asia","c",2008,"NF",6,5,3,4,4,0,"0",11,7,4,7,7,25,36
"3039","Mali","Africa","c",2008,"F",2,3,9,12,9,0,"0",30,15,9,9,9,42,72
"3040","Malta","Europe","c",2008,"F",1,1,12,16,11,0,"0",39,16,12,15,15,58,97
"3041","Marshall Islands","Asia","c",2008,"F",1,1,12,15,10,0,"0",37,16,11,15,13,55,92
"3042","Mauritania","Africa","c",2008,"PF",4,4,9,7,6,0,"0",22,10,8,6,6,30,52
"3043","Mauritius","Africa","c",2008,"F",1,2,12,15,11,0,"0",38,15,12,13,12,52,90
"3044","Mexico","Americas","c",2008,"F",2,3,10,14,8,0,"0",32,14,9,7,11,41,73
"3045","Micronesia","Asia","c",2008,"F",1,1,12,15,10,0,"0",37,16,11,15,14,56,93
"3046","Moldova","Eurasia","c",2008,"PF",3,4,9,8,7,0,"0",24,10,6,8,9,33,57
"3047","Monaco","Europe","c",2008,"F",2,1,10,11,10,0,"0",31,15,12,15,14,56,87
"3048","Mongolia","Asia","c",2008,"F",2,2,8,15,10,0,"0",33,15,10,12,12,49,82
"3049","Montenegro","Europe","c",2008,"PF",3,3,9,9,6,0,"0",24,12,10,8,11,41,65
"3050","Morocco","Africa","c",2008,"PF",5,4,4,7,5,0,"0",16,8,6,6,8,28,44
"3051","Mozambique","Africa","c",2008,"PF",3,3,7,11,7,0,"0",25,12,7,7,9,35,60
"3052","Myanmar","Asia","c",2008,"NF",7,7,0,1,0,3,"0",-2,2,0,0,3,5,3
"3053","Nagorno-Karabakh","Eurasia","t",2008,"PF",5,5,6,5,3,0,"0",14,7,3,5,5,20,34
"3054","Namibia","Africa","c",2008,"F",2,2,10,12,9,0,"0",31,15,12,10,9,46,77
"3055","Nauru","Asia","c",2008,"F",1,1,12,16,10,0,"0",38,15,11,15,14,55,93
"3056","Nepal","Asia","c",2008,"PF",5,4,4,9,4,0,"0",17,10,6,6,7,29,46
"3057","Netherlands","Europe","c",2008,"F",1,1,12,16,12,0,"0",40,16,12,15,16,59,99
"3058","New Zealand","Asia","c",2008,"F",1,1,12,15,12,0,"0",39,16,11,15,15,57,96
"3059","Nicaragua","Americas","c",2008,"PF",3,3,11,12,4,0,"0",27,14,7,7,9,37,64
"3060","Niger","Africa","c",2008,"PF",3,4,11,9,8,0,"0",28,10,8,8,6,32,60
"3061","Nigeria","Africa","c",2008,"PF",4,4,3,9,6,0,"0",18,11,8,5,7,31,49
"3062","North Korea","Asia","c",2008,"NF",7,7,0,0,0,0,"0",0,0,0,0,2,2,2
"3063","Northern Cyprus","Europe","t",2008,"F",2,2,11,14,9,0,"0",34,13,9,12,12,46,80
"3064","Norway","Europe","c",2008,"F",1,1,12,16,12,0,"0",40,16,12,16,16,60,100
"3065","Oman","Middle East","c",2008,"NF",6,5,2,2,2,0,"4",10,6,3,4,5,18,28
"3066","Pakistan","Asia","c",2008,"NF",6,5,2,4,2,0,"0",8,5,4,3,6,18,26
"3067","Pakistani Kashmir","Asia","t",2008,"NF",7,5,1,3,1,2,"0",3,6,4,4,6,20,23
"3068","Palau","Asia","c",2008,"F",1,1,12,15,10,0,"0",37,16,11,15,13,55,92
"3069","Palestinian Authority Administered Territories","Middle East","t",2008,"NF",5,6,4,7,2,0,"0",13,5,4,1,4,14,27
"3070","Panama","Americas","c",2008,"F",1,2,12,15,9,0,"0",36,15,11,9,12,47,83
"3071","Papua New Guinea","Asia","c",2008,"PF",3,3,9,11,4,0,"0",24,12,9,7,8,36,60
"3072","Paraguay","Americas","c",2008,"PF",3,3,11,11,4,0,"0",26,12,8,6,10,36,62
"3073","Peru","Americas","c",2008,"F",2,3,11,14,7,0,"0",32,15,8,8,10,41,73
"3074","Philippines","Asia","c",2008,"PF",4,3,6,10,7,0,"0",23,14,8,6,10,38,61
"3075","Poland","Europe","c",2008,"F",1,1,12,16,10,0,"0",38,16,12,13,14,55,93
"3076","Portugal","Europe","c",2008,"F",1,1,12,16,12,0,"0",40,16,12,15,15,58,98
"3077","Puerto Rico","Americas","t",2008,"F",1,1,12,15,10,0,"0",37,16,11,14,14,55,92
"3078","Qatar","Middle East","c",2008,"NF",6,5,2,2,3,0,"3",10,8,2,4,4,18,28
"3079","Romania","Europe","c",2008,"F",2,2,11,14,7,0,"0",32,14,11,12,12,49,81
"3080","Russia","Eurasia","c",2008,"NF",6,5,3,3,3,0,"0",9,8,4,4,7,23,32
"3081","Rwanda","Africa","c",2008,"NF",6,5,3,4,4,0,"0",11,7,3,6,7,23,34
"3082","Samoa","Asia","c",2008,"F",2,2,9,13,10,0,"0",32,14,10,13,12,49,81
"3083","San Marino","Europe","c",2008,"F",1,1,12,16,12,0,"0",40,16,12,16,16,60,100
"3084","Sao Tome and Principe","Africa","c",2008,"F",2,2,11,14,8,0,"0",33,15,10,12,10,47,80
"3085","Saudi Arabia","Middle East","c",2008,"NF",7,6,0,0,1,0,"3",4,4,0,3,2,9,13
"3086","Senegal","Africa","c",2008,"F",2,3,9,12,9,0,"0",30,14,10,10,9,43,73
"3087","Serbia","Europe","c",2008,"F",3,2,9,13,7,0,"0",29,14,11,9,13,47,76
"3088","Seychelles","Africa","c",2008,"PF",3,3,8,10,7,0,"0",25,9,9,11,11,40,65
"3089","Sierra Leone","Africa","c",2008,"PF",3,3,10,12,4,0,"0",26,12,8,8,9,37,63
"3090","Singapore","Asia","c",2008,"PF",5,4,4,6,7,0,"0",17,9,3,8,12,32,49
"3091","Slovakia","Europe","c",2008,"F",1,1,12,15,10,0,"0",37,16,12,12,14,54,91
"3092","Slovenia","Europe","c",2008,"F",1,1,12,15,11,0,"0",38,15,12,14,12,53,91
"3093","Solomon Islands","Asia","c",2008,"PF",4,3,6,10,5,0,"0",21,13,9,8,12,42,63
"3094","Somalia","Africa","c",2008,"NF",7,7,0,0,0,0,"0",0,3,0,0,0,3,3
"3095","South Africa","Africa","c",2008,"F",2,2,12,14,9,0,"0",35,15,12,12,12,51,86
"3096","South Korea","Asia","c",2008,"F",1,2,11,15,10,0,"0",36,14,11,13,12,50,86
"3097","Spain","Europe","c",2008,"F",1,1,12,15,12,0,"0",39,16,12,14,15,57,96
"3098","Sri Lanka","Asia","c",2008,"PF",4,4,8,7,6,0,"0",21,8,8,6,9,31,52
"3099","St. Kitts and Nevis","Americas","c",2008,"F",1,1,12,16,11,0,"0",39,15,12,12,14,53,92
"3100","St. Lucia","Americas","c",2008,"F",1,1,12,16,11,0,"0",39,15,12,12,14,53,92
"3101","St. Vincent and the Grenadines","Americas","c",2008,"F",2,1,11,15,9,0,"0",35,15,11,13,14,53,88
"3102","Sudan","Africa","c",2008,"NF",7,7,0,4,3,4,"0",3,4,3,0,0,7,10
"3103","Suriname","Americas","c",2008,"F",2,2,12,13,8,0,"0",33,15,11,9,10,45,78
"3104","Swaziland","Africa","c",2008,"NF",7,5,0,1,1,0,"1",3,8,3,4,5,20,23
"3105","Sweden","Europe","c",2008,"F",1,1,12,16,12,0,"0",40,16,12,16,16,60,100
"3106","Switzerland","Europe","c",2008,"F",1,1,12,15,12,0,"0",39,16,12,15,15,58,97
"3107","Syria","Middle East","c",2008,"NF",7,6,0,0,1,0,"0",1,2,0,1,5,8,9
"3108","Taiwan","Asia","c",2008,"F",2,1,10,15,9,0,"0",34,16,11,15,13,55,89
"3109","Tajikistan","Eurasia","c",2008,"NF",6,5,2,4,3,0,"0",9,6,4,4,5,19,28
"3110","Tanzania","Africa","c",2008,"PF",4,3,6,10,6,0,"0",22,11,7,10,8,36,58
"3111","Thailand","Asia","c",2008,"PF",6,4,1,4,3,0,"0",8,9,5,6,11,31,39
"3112","The Gambia","Africa","c",2008,"PF",5,4,6,7,4,0,"0",17,10,6,7,8,31,48
"3113","Tibet","Asia","t",2008,"NF",7,7,0,0,1,3,"0",-2,0,0,0,4,4,2
"3114","Timor-Leste","Asia","c",2008,"PF",3,4,11,11,6,0,"0",28,12,7,6,9,34,62
"3115","Togo","Africa","c",2008,"PF",5,5,4,7,3,0,"0",14,8,6,4,6,24,38
"3116","Tonga","Asia","c",2008,"PF",5,3,3,9,3,0,"0",15,12,5,11,12,40,55
"3117","Transnistria","Eurasia","t",2008,"NF",6,6,2,4,1,0,"0",7,6,2,2,5,15,22
"3118","Trinidad and Tobago","Americas","c",2008,"F",2,2,11,12,9,0,"0",32,15,11,10,13,49,81
"3119","Tunisia","Africa","c",2008,"NF",7,5,1,3,1,0,"0",5,4,2,4,8,18,23
"3120","Turkey","Europe","c",2008,"PF",3,3,10,12,7,0,"0",29,12,7,8,10,37,66
"3121","Turkmenistan","Eurasia","c",2008,"NF",7,7,0,0,0,0,"0",0,2,0,1,2,5,5
"3122","Tuvalu","Asia","c",2008,"F",1,1,12,15,10,0,"0",37,16,12,15,14,57,94
"3123","Uganda","Africa","c",2008,"PF",5,4,4,7,4,0,"0",15,11,6,6,7,30,45
"3124","Ukraine","Eurasia","c",2008,"F",3,2,10,13,6,0,"0",29,13,10,10,11,44,73
"3125","United Arab Emirates","Middle East","c",2008,"NF",6,5,1,2,2,0,"4",9,7,3,3,4,17,26
"3126","United Kingdom","Europe","c",2008,"F",1,1,12,16,12,0,"0",40,16,12,14,15,57,97
"3127","United States","Americas","c",2008,"F",1,1,11,16,11,0,"0",38,16,11,14,15,56,94
"3128","Uruguay","Americas","c",2008,"F",1,1,12,16,11,0,"0",39,16,12,15,15,58,97
"3129","Uzbekistan","Eurasia","c",2008,"NF",7,7,0,0,0,0,"0",0,1,0,0,2,3,3
"3130","Vanuatu","Asia","c",2008,"F",2,2,9,15,8,0,"0",32,16,11,10,11,48,80
"3131","Venezuela","Americas","c",2008,"PF",4,4,8,8,3,0,"0",19,9,6,5,8,28,47
"3132","Vietnam","Asia","c",2008,"NF",7,5,0,1,1,0,"0",2,5,2,4,8,19,21
"3133","Western Sahara","Africa","t",2008,"NF",7,6,0,0,0,2,"0",-2,3,3,0,5,11,9
"3134","Yemen","Middle East","c",2008,"PF",5,5,4,7,3,0,"0",14,7,4,4,5,20,34
"3135","Zambia","Africa","c",2008,"PF",3,4,8,12,6,0,"0",26,11,8,8,7,34,60
"3136","Zimbabwe","Africa","c",2008,"NF",7,6,1,4,0,0,"0",5,5,2,1,1,9,14
"3137","Abkhazia","Eurasia","t",2007,"PF",5,5,5,5,3,0,"0",13,8,4,4,5,21,34
"3138","Afghanistan","Asia","c",2007,"PF",5,5,6,7,4,0,"0",17,5,5,3,5,18,35
"3139","Albania","Europe","c",2007,"PF",3,3,8,11,7,0,"0",26,11,8,10,9,38,64
"3140","Algeria","Africa","c",2007,"NF",6,5,4,4,3,0,"0",11,7,6,5,7,25,36
"3141","Andorra","Europe","c",2007,"F",1,1,12,15,12,0,"0",39,16,11,15,15,57,96
"3142","Angola","Africa","c",2007,"NF",6,5,2,5,1,0,"0",8,8,6,4,3,21,29
"3143","Antigua and Barbuda","Americas","c",2007,"F",2,2,11,12,7,0,"0",30,13,9,12,13,47,77
"3144","Argentina","Americas","c",2007,"F",2,2,11,15,7,0,"0",33,14,11,10,13,48,81
"3145","Armenia","Eurasia","c",2007,"PF",5,4,4,5,4,0,"0",13,8,5,6,9,28,41
"3146","Australia","Asia","c",2007,"F",1,1,12,15,12,0,"0",39,16,12,14,15,57,96
"3147","Austria","Europe","c",2007,"F",1,1,12,16,12,0,"0",40,16,12,15,15,58,98
"3148","Azerbaijan","Eurasia","c",2007,"NF",6,5,3,4,3,0,"0",10,7,3,4,8,22,32
"3149","Bahamas","Americas","c",2007,"F",1,1,12,16,10,0,"0",38,16,12,15,15,58,96
"3150","Bahrain","Middle East","c",2007,"PF",5,5,3,9,4,0,"0",16,8,3,4,5,20,36
"3151","Bangladesh","Asia","c",2007,"PF",4,4,8,10,4,0,"0",22,8,8,6,9,31,53
"3152","Barbados","Americas","c",2007,"F",1,1,12,16,12,0,"0",40,16,12,16,15,59,99
"3153","Belarus","Eurasia","c",2007,"NF",7,6,0,3,1,0,"0",4,3,0,2,5,10,14
"3154","Belgium","Europe","c",2007,"F",1,1,12,16,12,0,"0",40,16,12,15,15,58,98
"3155","Belize","Americas","c",2007,"F",1,2,12,14,10,0,"0",36,15,11,12,13,51,87
"3156","Benin","Africa","c",2007,"F",2,2,10,15,8,0,"0",33,15,12,12,10,49,82
"3157","Bhutan","Asia","c",2007,"NF",6,5,3,1,5,1,"2",10,7,2,4,8,21,31
"3158","Bolivia","Americas","c",2007,"PF",3,3,11,13,4,0,"0",28,15,11,8,9,43,71
"3159","Bosnia and Herzegovina","Europe","c",2007,"PF",3,3,8,11,6,0,"0",25,11,8,10,10,39,64
"3160","Botswana","Africa","c",2007,"F",2,2,11,11,9,0,"0",31,14,10,13,10,47,78
"3161","Brazil","Americas","c",2007,"F",2,2,11,14,6,0,"0",31,15,10,8,12,45,76
"3162","Brunei","Asia","c",2007,"NF",6,5,0,3,3,0,"1",7,6,3,6,8,23,30
"3163","Bulgaria","Europe","c",2007,"F",1,2,12,15,9,0,"0",36,14,11,12,12,49,85
"3164","Burkina Faso","Africa","c",2007,"PF",5,3,5,8,4,0,"0",17,14,9,6,8,37,54
"3165","Burundi","Africa","c",2007,"PF",4,5,9,9,4,0,"0",22,8,5,4,6,23,45
"3166","Cambodia","Asia","c",2007,"NF",6,5,3,5,3,0,"0",11,9,6,2,7,24,35
"3167","Cameroon","Africa","c",2007,"NF",6,6,3,5,3,0,"0",11,7,3,2,4,16,27
"3168","Canada","Americas","c",2007,"F",1,1,12,16,12,0,"0",40,16,12,15,16,59,99
"3169","Cape Verde","Africa","c",2007,"F",1,1,12,15,10,0,"0",37,15,11,14,13,53,90
"3170","Central African Republic","Africa","c",2007,"PF",5,4,7,7,3,0,"0",17,10,9,3,4,26,43
"3171","Chad","Africa","c",2007,"NF",6,6,3,1,2,0,"0",6,7,5,1,3,16,22
"3172","Chechnya","Eurasia","t",2007,"NF",7,7,0,0,0,0,"0",0,4,0,0,2,6,6
"3173","Chile","Americas","c",2007,"F",1,1,12,15,12,0,"0",39,16,12,15,15,58,97
"3174","China","Asia","c",2007,"NF",7,6,0,1,1,0,"0",2,4,2,2,7,15,17
"3175","Colombia","Americas","c",2007,"PF",3,3,10,9,7,0,"0",26,12,7,7,10,36,62
"3176","Comoros","Africa","c",2007,"PF",3,4,9,11,4,0,"0",24,10,6,8,6,30,54
"3177","Congo (Brazzaville)","Africa","c",2007,"NF",6,5,3,5,3,0,"0",11,9,7,2,6,24,35
"3178","Congo (Kinshasa)","Africa","c",2007,"NF",5,6,6,6,2,0,"0",14,6,5,0,1,12,26
"3179","Costa Rica","Americas","c",2007,"F",1,1,12,15,11,0,"0",38,16,11,13,13,53,91
"3180","Cote d'Ivoire","Africa","c",2007,"NF",7,6,1,2,2,0,"0",5,5,4,3,4,16,21
"3181","Croatia","Europe","c",2007,"F",2,2,12,14,9,0,"0",35,14,12,11,13,50,85
"3182","Cuba","Americas","c",2007,"NF",7,7,0,0,1,0,"0",1,2,1,1,2,6,7
"3183","Cyprus","Europe","c",2007,"F",1,1,11,16,11,0,"0",38,15,12,15,15,57,95
"3184","Czech Republic","Europe","c",2007,"F",1,1,12,15,11,0,"0",38,16,12,14,15,57,95
"3185","Denmark","Europe","c",2007,"F",1,1,12,16,12,0,"0",40,16,12,15,15,58,98
"3186","Djibouti","Africa","c",2007,"PF",5,5,4,5,3,0,"0",12,7,5,5,6,23,35
"3187","Dominica","Americas","c",2007,"F",1,1,12,16,10,0,"0",38,16,12,13,13,54,92
"3188","Dominican Republic","Americas","c",2007,"F",2,2,11,13,9,0,"0",33,15,11,10,11,47,80
"3189","Ecuador","Americas","c",2007,"PF",3,3,9,15,4,0,"0",28,15,11,5,10,41,69
"3190","Egypt","Africa","c",2007,"NF",6,5,1,4,2,0,"0",7,6,2,5,7,20,27
"3191","El Salvador","Americas","c",2007,"F",2,3,12,13,8,0,"0",33,15,9,7,10,41,74
"3192","Equatorial Guinea","Africa","c",2007,"NF",7,6,0,1,0,0,"0",1,5,0,1,3,9,10
"3193","Eritrea","Africa","c",2007,"NF",7,6,0,1,2,0,"0",3,2,0,2,6,10,13
"3194","Estonia","Europe","c",2007,"F",1,1,12,15,12,0,"0",39,16,12,14,14,56,95
"3195","Ethiopia","Africa","c",2007,"PF",5,5,5,5,4,0,"0",14,7,3,4,6,20,34
"3196","Fiji","Asia","c",2007,"PF",6,4,0,5,2,0,"0",7,10,4,7,10,31,38
"3197","Finland","Europe","c",2007,"F",1,1,12,16,12,0,"0",40,16,12,16,16,60,100
"3198","France","Europe","c",2007,"F",1,1,12,15,11,0,"0",38,15,12,14,15,56,94
"3199","Gabon","Africa","c",2007,"PF",6,4,2,5,3,0,"0",10,10,6,6,5,27,37
"3200","Georgia","Eurasia","c",2007,"PF",3,3,9,9,7,0,"0",25,12,8,7,10,37,62
"3201","Germany","Europe","c",2007,"F",1,1,12,15,12,0,"0",39,15,12,15,15,57,96
"3202","Ghana","Africa","c",2007,"F",1,2,12,15,10,0,"0",37,14,11,12,10,47,84
"3203","Greece","Europe","c",2007,"F",1,2,12,15,10,0,"0",37,15,10,14,13,52,89
"3204","Grenada","Americas","c",2007,"F",1,2,12,16,9,0,"0",37,15,9,11,14,49,86
"3205","Guatemala","Americas","c",2007,"PF",3,4,9,10,5,0,"0",24,12,8,5,8,33,57
"3206","Guinea","Africa","c",2007,"NF",6,5,2,5,2,0,"0",9,8,5,4,6,23,32
"3207","Guinea-Bissau","Africa","c",2007,"PF",4,4,9,9,4,0,"0",22,11,8,8,6,33,55
"3208","Guyana","Americas","c",2007,"F",2,3,11,13,7,0,"0",31,15,10,8,9,42,73
"3209","Haiti","Americas","c",2007,"PF",4,5,7,10,3,0,"0",20,10,5,2,5,22,42
"3210","Honduras","Americas","c",2007,"PF",3,3,9,10,6,0,"0",25,13,8,7,9,37,62
"3211","Hong Kong","Asia","t",2007,"PF",5,2,3,7,6,0,"0",16,14,10,14,13,51,67
"3212","Hungary","Europe","c",2007,"F",1,1,12,15,10,0,"0",37,16,12,13,14,55,92
"3213","Iceland","Europe","c",2007,"F",1,1,12,16,12,0,"0",40,16,12,16,16,60,100
"3214","India","Asia","c",2007,"F",2,3,11,14,9,0,"0",34,13,10,9,10,42,76
"3215","Indian Kashmir","Asia","t",2007,"PF",5,5,6,6,3,0,"0",15,8,6,3,8,25,40
"3216","Indonesia","Asia","c",2007,"F",2,3,11,13,6,0,"0",30,10,9,7,9,35,65
"3217","Iran","Middle East","c",2007,"NF",6,6,3,4,3,0,"0",10,4,2,3,4,13,23
"3218","Iraq","Middle East","c",2007,"NF",6,6,7,6,1,3,"0",11,4,3,0,4,11,22
"3219","Ireland","Europe","c",2007,"F",1,1,12,16,11,0,"0",39,16,12,15,15,58,97
"3220","Israel","Middle East","c",2007,"F",1,2,12,15,10,0,"0",37,14,12,10,11,47,84
"3221","Israeli Occupied Territories","Middle East","t",2007,"NF",6,5,3,3,3,1,"0",8,6,5,1,5,17,25
"3222","Italy","Europe","c",2007,"F",1,1,12,15,11,0,"0",38,15,12,12,15,54,92
"3223","Jamaica","Americas","c",2007,"F",2,3,10,13,8,0,"0",31,15,9,8,11,43,74
"3224","Japan","Asia","c",2007,"F",1,2,12,15,10,0,"0",37,13,10,15,13,51,88
"3225","Jordan","Middle East","c",2007,"PF",5,4,3,6,5,0,"0",14,9,5,6,8,28,42
"3226","Kazakhstan","Eurasia","c",2007,"NF",6,5,3,4,3,0,"0",10,7,4,4,7,22,32
"3227","Kenya","Africa","c",2007,"PF",3,3,9,11,5,0,"0",25,14,9,8,8,39,64
"3228","Kiribati","Asia","c",2007,"F",1,1,12,16,8,0,"0",36,15,12,15,13,55,91
"3229","Kosovo","Eurasia","t",2007,"PF",6,5,6,5,3,0,"3",11,7,6,4,7,18,29
"3230","Kuwait","Middle East","c",2007,"PF",4,4,4,9,6,0,"0",19,9,6,7,5,27,46
"3231","Kyrgyzstan","Eurasia","c",2007,"PF",5,4,5,7,4,0,"0",16,10,8,5,7,30,46
"3232","Laos","Asia","c",2007,"NF",7,6,0,1,0,0,"0",1,4,1,2,5,12,13
"3233","Latvia","Europe","c",2007,"F",1,1,12,15,9,0,"0",36,16,12,12,13,53,89
"3234","Lebanon","Middle East","c",2007,"PF",5,4,4,8,5,0,"0",17,12,8,5,9,34,51
"3235","Lesotho","Africa","c",2007,"F",2,3,9,12,9,0,"0",30,15,8,11,9,43,73
"3236","Liberia","Africa","c",2007,"PF",3,4,9,10,5,0,"0",24,11,7,7,8,33,57
"3237","Libya","Africa","c",2007,"NF",7,7,0,1,0,0,"0",1,1,0,0,6,7,8
"3238","Liechtenstein","Europe","c",2007,"F",1,1,12,16,12,0,"0",40,16,12,16,16,60,100
"3239","Lithuania","Europe","c",2007,"F",1,1,12,15,9,0,"0",36,16,11,14,13,54,90
"3240","Luxembourg","Europe","c",2007,"F",1,1,12,16,12,0,"0",40,16,12,16,16,60,100
"3241","Macedonia","Europe","c",2007,"PF",3,3,7,10,7,0,"0",24,11,7,8,10,36,60
"3242","Madagascar","Africa","c",2007,"PF",4,3,7,9,7,0,"0",23,10,8,9,9,36,59
"3243","Malawi","Africa","c",2007,"PF",4,3,7,10,6,0,"0",23,11,8,9,7,35,58
"3244","Malaysia","Asia","c",2007,"PF",4,4,6,7,6,0,"0",19,8,6,6,9,29,48
"3245","Maldives","Asia","c",2007,"NF",6,5,3,4,4,0,"0",11,6,3,7,7,23,34
"3246","Mali","Africa","c",2007,"F",2,2,9,12,9,0,"0",30,16,9,10,9,44,74
"3247","Malta","Europe","c",2007,"F",1,1,12,16,11,0,"0",39,16,12,16,15,59,98
"3248","Marshall Islands","Asia","c",2007,"F",1,1,12,15,10,0,"0",37,16,11,15,13,55,92
"3249","Mauritania","Africa","c",2007,"PF",5,4,6,7,4,0,"0",17,10,8,6,5,29,46
"3250","Mauritius","Africa","c",2007,"F",1,2,11,15,11,0,"0",37,15,12,13,12,52,89
"3251","Mexico","Americas","c",2007,"F",2,3,10,14,9,0,"0",33,14,10,8,11,43,76
"3252","Micronesia","Asia","c",2007,"F",1,1,12,15,10,0,"0",37,16,11,15,14,56,93
"3253","Moldova","Eurasia","c",2007,"PF",3,4,9,8,7,0,"0",24,10,6,8,9,33,57
"3254","Monaco","Europe","c",2007,"F",2,1,10,11,10,0,"0",31,15,12,15,14,56,87
"3255","Mongolia","Asia","c",2007,"F",2,2,8,15,10,0,"0",33,15,10,12,12,49,82
"3256","Montenegro","Europe","c",2007,"PF",3,3,9,9,6,0,"0",24,12,10,8,11,41,65
"3257","Morocco","Africa","c",2007,"PF",5,4,4,7,6,0,"0",17,8,6,6,8,28,45
"3258","Mozambique","Africa","c",2007,"PF",3,4,7,11,7,0,"0",25,11,7,7,8,33,58
"3259","Myanmar","Asia","c",2007,"NF",7,7,0,1,0,3,"0",-2,2,0,0,4,6,4
"3260","Nagorno-Karabakh","Eurasia","t",2007,"PF",5,5,6,5,3,0,"0",14,8,4,4,5,21,35
"3261","Namibia","Africa","c",2007,"F",2,2,10,12,9,0,"0",31,15,12,10,9,46,77
"3262","Nauru","Asia","c",2007,"F",1,1,12,16,10,0,"0",38,15,11,15,14,55,93
"3263","Nepal","Asia","c",2007,"PF",5,4,4,9,4,0,"0",17,9,6,6,7,28,45
"3264","Netherlands","Europe","c",2007,"F",1,1,12,16,12,0,"0",40,16,12,15,16,59,99
"3265","New Zealand","Asia","c",2007,"F",1,1,12,15,12,0,"0",39,16,11,15,15,57,96
"3266","Nicaragua","Americas","c",2007,"PF",3,3,11,12,5,0,"0",28,14,8,7,10,39,67
"3267","Niger","Africa","c",2007,"PF",3,3,11,10,8,0,"0",29,11,9,9,6,35,64
"3268","Nigeria","Africa","c",2007,"PF",4,4,6,9,6,0,"0",21,11,7,5,7,30,51
"3269","North Korea","Asia","c",2007,"NF",7,7,0,0,0,0,"0",0,0,0,0,1,1,1
"3270","Northern Cyprus","Europe","t",2007,"F",2,2,11,14,9,0,"0",34,13,9,12,12,46,80
"3271","Norway","Europe","c",2007,"F",1,1,12,16,12,0,"0",40,16,12,16,16,60,100
"3272","Oman","Middle East","c",2007,"NF",6,5,2,2,2,0,"4",10,6,3,4,5,18,28
"3273","Pakistan","Asia","c",2007,"NF",6,5,2,6,3,0,"0",11,8,6,4,6,24,35
"3274","Pakistani Kashmir","Asia","t",2007,"NF",7,5,2,3,2,2,"0",5,6,4,4,6,20,25
"3275","Palau","Asia","c",2007,"F",1,1,12,15,10,0,"0",37,16,11,15,13,55,92
"3276","Palestinian Authority Administered Territories","Middle East","t",2007,"PF",4,6,6,9,3,0,"0",18,5,5,1,5,16,34
"3277","Panama","Americas","c",2007,"F",1,2,12,15,9,0,"0",36,15,11,9,12,47,83
"3278","Papua New Guinea","Asia","c",2007,"PF",3,3,9,11,6,0,"0",26,12,9,7,8,36,62
"3279","Paraguay","Americas","c",2007,"PF",3,3,11,11,4,0,"0",26,12,8,7,10,37,63
"3280","Peru","Americas","c",2007,"F",2,3,11,14,7,0,"0",32,15,9,8,9,41,73
"3281","Philippines","Asia","c",2007,"PF",3,3,7,13,8,0,"0",28,14,9,8,10,41,69
"3282","Poland","Europe","c",2007,"F",1,1,12,16,10,0,"0",38,15,11,13,14,53,91
"3283","Portugal","Europe","c",2007,"F",1,1,12,16,12,0,"0",40,16,12,15,14,57,97
"3284","Puerto Rico","Americas","t",2007,"F",1,1,12,15,10,0,"0",37,16,11,14,14,55,92
"3285","Qatar","Middle East","c",2007,"NF",6,5,2,1,3,0,"3",9,8,2,4,4,18,27
"3286","Romania","Europe","c",2007,"F",2,2,11,14,7,0,"0",32,14,11,12,12,49,81
"3287","Russia","Eurasia","c",2007,"NF",6,5,3,5,3,0,"0",11,8,4,4,7,23,34
"3288","Rwanda","Africa","c",2007,"NF",6,5,3,3,4,0,"0",10,7,3,6,7,23,33
"3289","Samoa","Asia","c",2007,"F",2,2,9,13,10,0,"0",32,14,10,13,12,49,81
"3290","San Marino","Europe","c",2007,"F",1,1,12,16,12,0,"0",40,16,12,16,16,60,100
"3291","Sao Tome and Principe","Africa","c",2007,"F",2,2,11,14,8,0,"0",33,15,10,12,10,47,80
"3292","Saudi Arabia","Middle East","c",2007,"NF",7,6,0,0,1,0,"3",4,4,0,3,2,9,13
"3293","Senegal","Africa","c",2007,"F",2,3,11,13,9,0,"0",33,15,10,9,9,43,76
"3294","Serbia","Europe","c",2007,"F",3,2,9,13,7,0,"0",29,14,11,9,13,47,76
"3295","Seychelles","Africa","c",2007,"PF",3,3,8,10,7,0,"0",25,10,9,11,11,41,66
"3296","Sierra Leone","Africa","c",2007,"PF",4,3,9,10,4,0,"0",23,12,8,8,9,37,60
"3297","Singapore","Asia","c",2007,"PF",5,4,4,6,7,0,"0",17,9,3,8,12,32,49
"3298","Slovakia","Europe","c",2007,"F",1,1,12,15,10,0,"0",37,16,12,12,14,54,91
"3299","Slovenia","Europe","c",2007,"F",1,1,12,15,11,0,"0",38,15,12,14,12,53,91
"3300","Solomon Islands","Asia","c",2007,"PF",4,3,6,10,7,0,"0",23,13,9,8,12,42,65
"3301","Somalia","Africa","c",2007,"NF",7,7,0,0,1,0,"0",1,3,0,0,0,3,4
"3302","South Africa","Africa","c",2007,"F",2,2,12,14,9,0,"0",35,15,12,12,12,51,86
"3303","South Korea","Asia","c",2007,"F",1,2,11,15,10,0,"0",36,14,12,13,12,51,87
"3304","Spain","Europe","c",2007,"F",1,1,12,15,12,0,"0",39,16,12,14,15,57,96
"3305","Sri Lanka","Asia","c",2007,"PF",4,4,8,8,7,0,"0",23,8,9,6,10,33,56
"3306","St. Kitts and Nevis","Americas","c",2007,"F",1,1,12,16,10,0,"0",38,15,12,12,14,53,91
"3307","St. Lucia","Americas","c",2007,"F",1,1,12,16,10,0,"0",38,15,12,12,14,53,91
"3308","St. Vincent and the Grenadines","Americas","c",2007,"F",2,1,11,15,8,0,"0",34,15,11,13,14,53,87
"3309","Sudan","Africa","c",2007,"NF",7,7,0,4,3,4,"0",3,4,3,0,0,7,10
"3310","Suriname","Americas","c",2007,"F",2,2,12,13,7,0,"0",32,15,11,9,10,45,77
"3311","Swaziland","Africa","c",2007,"NF",7,5,0,1,1,0,"1",3,8,3,4,5,20,23
"3312","Sweden","Europe","c",2007,"F",1,1,12,16,12,0,"0",40,16,12,16,16,60,100
"3313","Switzerland","Europe","c",2007,"F",1,1,12,16,12,0,"0",40,16,12,15,16,59,99
"3314","Syria","Middle East","c",2007,"NF",7,6,0,0,1,0,"0",1,2,0,1,5,8,9
"3315","Taiwan","Asia","c",2007,"F",2,1,10,15,9,0,"0",34,16,11,15,13,55,89
"3316","Tajikistan","Eurasia","c",2007,"NF",6,5,2,4,3,1,"0",8,6,4,4,6,20,28
"3317","Tanzania","Africa","c",2007,"PF",4,3,6,10,6,0,"0",22,11,7,10,8,36,58
"3318","Thailand","Asia","c",2007,"NF",7,4,0,1,3,0,"0",4,10,5,6,11,32,36
"3319","The Gambia","Africa","c",2007,"PF",5,4,6,7,4,0,"0",17,10,6,7,8,31,48
"3320","Tibet","Asia","t",2007,"NF",7,7,0,0,1,3,"0",-2,0,0,0,5,5,3
"3321","Timor-Leste","Asia","c",2007,"PF",3,4,11,10,5,0,"0",26,11,7,6,9,33,59
"3322","Togo","Africa","c",2007,"NF",6,5,2,4,2,0,"0",8,7,5,3,6,21,29
"3323","Tonga","Asia","c",2007,"PF",5,3,3,9,3,0,"0",15,12,5,11,12,40,55
"3324","Transnistria","Eurasia","t",2007,"NF",6,6,2,4,1,0,"0",7,6,2,2,5,15,22
"3325","Trinidad and Tobago","Americas","c",2007,"F",2,2,9,13,9,0,"0",31,15,11,10,13,49,80
"3326","Tunisia","Africa","c",2007,"NF",6,5,1,3,2,0,"0",6,4,2,4,8,18,24
"3327","Turkey","Europe","c",2007,"PF",3,3,9,12,7,0,"0",28,12,7,8,10,37,65
"3328","Turkmenistan","Eurasia","c",2007,"NF",7,7,0,0,0,0,"0",0,1,0,0,0,1,1
"3329","Tuvalu","Asia","c",2007,"F",1,1,12,15,10,0,"0",37,16,12,15,14,57,94
"3330","Uganda","Africa","c",2007,"PF",5,4,4,7,4,0,"0",15,11,6,7,7,31,46
"3331","Ukraine","Eurasia","c",2007,"F",3,2,9,13,6,0,"0",28,13,10,11,11,45,73
"3332","United Arab Emirates","Middle East","c",2007,"NF",6,5,1,1,2,0,"4",8,6,3,4,4,17,25
"3333","United Kingdom","Europe","c",2007,"F",1,1,12,16,12,0,"0",40,16,12,15,15,58,98
"3334","United States","Americas","c",2007,"F",1,1,11,16,11,0,"0",38,16,10,14,15,55,93
"3335","Uruguay","Americas","c",2007,"F",1,1,12,16,11,0,"0",39,16,12,15,15,58,97
"3336","Uzbekistan","Eurasia","c",2007,"NF",7,7,0,0,0,0,"0",0,1,0,0,2,3,3
"3337","Vanuatu","Asia","c",2007,"F",2,2,9,15,8,0,"0",32,16,11,10,11,48,80
"3338","Venezuela","Americas","c",2007,"PF",4,4,8,8,4,0,"0",20,11,7,5,8,31,51
"3339","Vietnam","Asia","c",2007,"NF",7,5,0,1,1,0,"0",2,5,2,4,8,19,21
"3340","Western Sahara","Africa","t",2007,"NF",7,6,0,0,0,2,"0",-2,3,2,0,5,10,8
"3341","Yemen","Middle East","c",2007,"PF",5,5,4,7,3,0,"0",14,7,3,4,5,19,33
"3342","Zambia","Africa","c",2007,"PF",3,4,8,11,6,0,"0",25,11,8,8,7,34,59
"3343","Zimbabwe","Africa","c",2007,"NF",7,6,1,3,0,0,"0",4,5,2,1,1,9,13
"3344","Abkhazia","Eurasia","t",2006,"PF",5,5,5,5,3,0,"0",13,8,4,4,5,21,34
"3345","Afghanistan","Asia","c",2006,"PF",5,5,6,7,3,0,"0",16,5,5,4,5,19,35
"3346","Albania","Europe","c",2006,"PF",3,3,8,11,6,0,"0",25,11,8,10,9,38,63
"3347","Algeria","Africa","c",2006,"NF",6,5,5,3,3,0,"0",11,8,6,4,7,25,36
"3348","Andorra","Europe","c",2006,"F",1,1,12,15,12,0,"0",39,16,11,15,15,57,96
"3349","Angola","Africa","c",2006,"NF",6,5,2,5,1,0,"0",8,8,6,4,3,21,29
"3350","Antigua and Barbuda","Americas","c",2006,"F",2,2,11,12,7,0,"0",30,13,9,12,13,47,77
"3351","Argentina","Americas","c",2006,"F",2,2,11,15,8,0,"0",34,15,11,11,13,50,84
"3352","Armenia","Eurasia","c",2006,"PF",5,4,4,5,4,0,"0",13,8,5,6,9,28,41
"3353","Australia","Asia","c",2006,"F",1,1,12,15,12,0,"0",39,16,12,14,15,57,96
"3354","Austria","Europe","c",2006,"F",1,1,12,16,12,0,"0",40,16,12,15,15,58,98
"3355","Azerbaijan","Eurasia","c",2006,"NF",6,5,3,4,3,0,"0",10,7,3,5,8,23,33
"3356","Bahamas","Americas","c",2006,"F",1,1,12,16,10,0,"0",38,16,12,15,15,58,96
"3357","Bahrain","Middle East","c",2006,"PF",5,5,3,6,5,0,"0",14,8,5,4,5,22,36
"3358","Bangladesh","Asia","c",2006,"PF",4,4,8,10,4,0,"0",22,8,8,6,9,31,53
"3359","Barbados","Americas","c",2006,"F",1,1,12,16,12,0,"0",40,16,12,16,15,59,99
"3360","Belarus","Eurasia","c",2006,"NF",7,6,1,3,1,0,"0",5,3,0,2,5,10,15
"3361","Belgium","Europe","c",2006,"F",1,1,12,15,12,0,"0",39,16,12,15,15,58,97
"3362","Belize","Americas","c",2006,"F",1,2,12,14,10,0,"0",36,15,11,13,13,52,88
"3363","Benin","Africa","c",2006,"F",2,2,8,14,8,0,"0",30,15,11,12,10,48,78
"3364","Bhutan","Asia","c",2006,"NF",6,5,2,1,5,1,"2",9,6,2,4,8,20,29
"3365","Bolivia","Americas","c",2006,"PF",3,3,10,13,5,0,"0",28,15,11,8,9,43,71
"3366","Bosnia and Herzegovina","Europe","c",2006,"PF",4,3,7,11,5,0,"0",23,11,8,10,10,39,62
"3367","Botswana","Africa","c",2006,"F",2,2,11,11,9,0,"0",31,14,10,13,10,47,78
"3368","Brazil","Americas","c",2006,"F",2,2,11,14,7,0,"0",32,15,10,8,12,45,77
"3369","Brunei","Asia","c",2006,"NF",6,5,0,3,2,0,"1",6,6,3,6,8,23,29
"3370","Bulgaria","Europe","c",2006,"F",1,2,12,15,9,0,"0",36,14,11,13,13,51,87
"3371","Burkina Faso","Africa","c",2006,"PF",5,3,5,8,4,0,"0",17,13,9,6,8,36,53
"3372","Burundi","Africa","c",2006,"PF",3,5,9,11,5,0,"0",25,9,5,4,6,24,49
"3373","Cambodia","Asia","c",2006,"NF",6,5,3,5,3,0,"0",11,9,6,2,7,24,35
"3374","Cameroon","Africa","c",2006,"NF",6,6,3,5,3,0,"0",11,7,3,2,4,16,27
"3375","Canada","Americas","c",2006,"F",1,1,12,16,11,0,"0",39,16,12,15,16,59,98
"3376","Cape Verde","Africa","c",2006,"F",1,1,12,15,10,0,"0",37,15,11,14,13,53,90
"3377","Central African Republic","Africa","c",2006,"PF",5,4,7,7,3,0,"0",17,10,9,3,5,27,44
"3378","Chad","Africa","c",2006,"NF",6,5,3,2,3,0,"0",8,7,6,2,3,18,26
"3379","Chechnya","Eurasia","t",2006,"NF",7,7,0,0,0,0,"0",0,4,0,0,1,5,5
"3380","Chile","Americas","c",2006,"F",1,1,12,15,12,0,"0",39,16,12,15,14,57,96
"3381","China","Asia","c",2006,"NF",7,6,0,1,1,0,"0",2,4,2,2,7,15,17
"3382","Colombia","Americas","c",2006,"PF",3,3,9,8,7,0,"0",24,12,7,7,10,36,60
"3383","Comoros","Africa","c",2006,"PF",4,4,7,8,3,0,"0",18,10,6,8,6,30,48
"3384","Congo (Brazzaville)","Africa","c",2006,"PF",5,5,3,5,4,0,"0",12,9,8,2,6,25,37
"3385","Congo (Kinshasa)","Africa","c",2006,"NF",6,6,1,5,2,0,"0",8,6,5,0,1,12,20
"3386","Costa Rica","Americas","c",2006,"F",1,1,12,15,11,0,"0",38,16,11,14,13,54,92
"3387","Cote d'Ivoire","Africa","c",2006,"NF",6,6,2,2,2,0,"0",6,5,3,3,4,15,21
"3388","Croatia","Europe","c",2006,"F",2,2,12,14,9,0,"0",35,14,12,10,13,49,84
"3389","Cuba","Americas","c",2006,"NF",7,7,0,0,1,0,"0",1,2,2,1,2,7,8
"3390","Cyprus","Europe","c",2006,"F",1,1,11,16,11,0,"0",38,15,12,15,15,57,95
"3391","Czech Republic","Europe","c",2006,"F",1,1,12,15,10,0,"0",37,16,12,13,14,55,92
"3392","Denmark","Europe","c",2006,"F",1,1,12,16,12,0,"0",40,16,12,15,15,58,98
"3393","Djibouti","Africa","c",2006,"PF",5,5,4,5,3,0,"0",12,7,5,5,6,23,35
"3394","Dominica","Americas","c",2006,"F",1,1,12,16,10,0,"0",38,16,12,13,13,54,92
"3395","Dominican Republic","Americas","c",2006,"F",2,2,11,13,8,0,"0",32,15,11,9,11,46,78
"3396","Ecuador","Americas","c",2006,"PF",3,3,8,15,4,0,"0",27,15,11,5,10,41,68
"3397","Egypt","Africa","c",2006,"NF",6,5,2,4,2,0,"0",8,7,3,5,7,22,30
"3398","El Salvador","Americas","c",2006,"F",2,3,12,13,7,0,"0",32,15,10,8,10,43,75
"3399","Equatorial Guinea","Africa","c",2006,"NF",7,6,0,1,0,0,"0",1,5,0,1,3,9,10
"3400","Eritrea","Africa","c",2006,"NF",7,6,0,1,2,0,"0",3,2,0,3,6,11,14
"3401","Estonia","Europe","c",2006,"F",1,1,12,15,12,0,"0",39,16,12,14,14,56,95
"3402","Ethiopia","Africa","c",2006,"PF",5,5,5,6,4,0,"0",15,7,3,5,6,21,36
"3403","Fiji","Asia","c",2006,"PF",4,3,6,8,6,0,"0",20,12,9,11,10,42,62
"3404","Finland","Europe","c",2006,"F",1,1,12,16,12,0,"0",40,16,12,16,16,60,100
"3405","France","Europe","c",2006,"F",1,1,12,15,11,0,"0",38,15,12,13,15,55,93
"3406","Gabon","Africa","c",2006,"PF",6,4,2,5,3,0,"0",10,11,6,7,6,30,40
"3407","Georgia","Eurasia","c",2006,"PF",3,3,9,9,6,0,"0",24,11,8,8,10,37,61
"3408","Germany","Europe","c",2006,"F",1,1,12,15,12,0,"0",39,16,12,15,15,58,97
"3409","Ghana","Africa","c",2006,"F",1,2,12,15,10,0,"0",37,14,11,12,10,47,84
"3410","Greece","Europe","c",2006,"F",1,2,12,15,10,0,"0",37,15,10,13,13,51,88
"3411","Grenada","Americas","c",2006,"F",1,2,12,16,9,0,"0",37,15,9,12,14,50,87
"3412","Guatemala","Americas","c",2006,"PF",4,4,9,8,5,0,"0",22,12,8,5,8,33,55
"3413","Guinea","Africa","c",2006,"NF",6,5,2,5,2,0,"0",9,8,5,4,6,23,32
"3414","Guinea-Bissau","Africa","c",2006,"PF",3,4,9,10,6,0,"0",25,12,8,8,6,34,59
"3415","Guyana","Americas","c",2006,"PF",3,3,10,12,7,0,"0",29,15,10,7,9,41,70
"3416","Haiti","Americas","c",2006,"NF",7,6,0,5,0,0,"0",5,8,3,0,5,16,21
"3417","Honduras","Americas","c",2006,"PF",3,3,9,11,6,0,"0",26,14,9,8,9,40,66
"3418","Hong Kong","Asia","t",2006,"PF",5,2,3,7,6,0,"0",16,14,10,14,13,51,67
"3419","Hungary","Europe","c",2006,"F",1,1,12,15,10,0,"0",37,16,12,14,14,56,93
"3420","Iceland","Europe","c",2006,"F",1,1,12,16,12,0,"0",40,16,12,16,16,60,100
"3421","India","Asia","c",2006,"F",2,3,11,14,9,0,"0",34,13,10,9,10,42,76
"3422","Indian Kashmir","Asia","t",2006,"PF",5,5,6,6,3,0,"0",15,8,6,3,8,25,40
"3423","Indonesia","Asia","c",2006,"F",2,3,11,13,6,0,"0",30,11,9,7,8,35,65
"3424","Iran","Middle East","c",2006,"NF",6,6,3,3,3,0,"0",9,5,3,3,4,15,24
"3425","Iraq","Middle East","c",2006,"NF",6,5,3,4,2,0,"0",9,6,5,2,6,19,28
"3426","Ireland","Europe","c",2006,"F",1,1,12,16,12,0,"0",40,16,12,15,15,58,98
"3427","Israel","Middle East","c",2006,"F",1,2,12,15,10,0,"0",37,14,11,10,11,46,83
"3428","Israeli Occupied Territories","Middle East","t",2006,"NF",6,5,2,2,3,1,"0",6,6,5,2,5,18,24
"3429","Italy","Europe","c",2006,"F",1,1,12,16,11,0,"0",39,14,12,12,15,53,92
"3430","Jamaica","Americas","c",2006,"F",2,3,10,13,8,0,"0",31,15,9,8,11,43,74
"3431","Japan","Asia","c",2006,"F",1,2,12,15,10,0,"0",37,13,10,15,13,51,88
"3432","Jordan","Middle East","c",2006,"PF",5,4,4,7,4,0,"0",15,8,5,7,7,27,42
"3433","Kazakhstan","Eurasia","c",2006,"NF",6,5,3,4,3,0,"0",10,7,4,4,7,22,32
"3434","Kenya","Africa","c",2006,"PF",3,3,9,11,6,0,"0",26,14,9,8,9,40,66
"3435","Kiribati","Asia","c",2006,"F",1,1,12,16,10,0,"0",38,15,12,15,13,55,93
"3436","Kosovo","Eurasia","t",2006,"PF",6,5,5,5,3,0,"3",10,6,6,2,5,19,29
"3437","Kuwait","Middle East","c",2006,"PF",4,5,4,8,6,0,"0",18,9,5,7,4,25,43
"3438","Kyrgyzstan","Eurasia","c",2006,"PF",5,4,5,7,4,0,"0",16,11,8,5,7,31,47
"3439","Laos","Asia","c",2006,"NF",7,6,0,1,0,0,"0",1,4,1,2,5,12,13
"3440","Latvia","Europe","c",2006,"F",1,1,12,15,9,0,"0",36,16,12,12,13,53,89
"3441","Lebanon","Middle East","c",2006,"PF",5,4,4,8,4,0,"0",16,11,7,5,7,30,46
"3442","Lesotho","Africa","c",2006,"F",2,3,10,12,9,0,"0",31,15,8,11,9,43,74
"3443","Liberia","Africa","c",2006,"PF",4,4,9,10,4,0,"0",23,11,7,7,8,33,56
"3444","Libya","Africa","c",2006,"NF",7,7,0,1,0,0,"0",1,1,0,0,5,6,7
"3445","Liechtenstein","Europe","c",2006,"F",1,1,12,16,12,0,"0",40,16,12,16,15,59,99
"3446","Lithuania","Europe","c",2006,"F",1,1,12,15,9,0,"0",36,16,11,14,13,54,90
"3447","Luxembourg","Europe","c",2006,"F",1,1,12,16,12,0,"0",40,16,12,16,16,60,100
"3448","Macedonia","Europe","c",2006,"PF",3,3,8,10,7,0,"0",25,11,7,8,10,36,61
"3449","Madagascar","Africa","c",2006,"PF",3,3,8,9,7,0,"0",24,10,8,9,9,36,60
"3450","Malawi","Africa","c",2006,"PF",4,4,7,10,6,0,"0",23,11,8,8,7,34,57
"3451","Malaysia","Asia","c",2006,"PF",4,4,6,7,6,0,"0",19,10,6,6,9,31,50
"3452","Maldives","Asia","c",2006,"NF",6,5,3,2,4,0,"0",9,6,3,6,7,22,31
"3453","Mali","Africa","c",2006,"F",2,2,9,12,9,0,"0",30,15,9,11,9,44,74
"3454","Malta","Europe","c",2006,"F",1,1,12,16,11,0,"0",39,16,12,16,15,59,98
"3455","Marshall Islands","Asia","c",2006,"F",1,1,12,15,10,0,"0",37,16,11,15,13,55,92
"3456","Mauritania","Africa","c",2006,"PF",6,4,2,6,3,0,"0",11,10,6,6,5,27,38
"3457","Mauritius","Africa","c",2006,"F",1,1,12,15,11,0,"0",38,15,12,14,12,53,91
"3458","Mexico","Americas","c",2006,"F",2,2,12,14,9,0,"0",35,15,10,8,12,45,80
"3459","Micronesia","Asia","c",2006,"F",1,1,12,15,10,0,"0",37,16,11,15,14,56,93
"3460","Moldova","Eurasia","c",2006,"PF",3,4,9,8,7,0,"0",24,10,6,8,9,33,57
"3461","Monaco","Europe","c",2006,"F",2,1,10,11,10,0,"0",31,15,12,15,14,56,87
"3462","Mongolia","Asia","c",2006,"F",2,2,9,15,10,0,"0",34,15,10,12,12,49,83
"3463","Morocco","Africa","c",2006,"PF",5,4,4,7,6,0,"0",17,8,6,4,8,26,43
"3464","Mozambique","Africa","c",2006,"PF",3,4,7,11,7,0,"0",25,10,7,6,8,31,56
"3465","Myanmar","Asia","c",2006,"NF",7,7,0,1,0,2,"0",-1,2,0,0,4,6,5
"3466","Nagorno-Karabakh","Eurasia","t",2006,"PF",5,5,6,5,3,0,"0",14,8,4,4,5,21,35
"3467","Namibia","Africa","c",2006,"F",2,2,10,12,9,0,"0",31,15,12,10,9,46,77
"3468","Nauru","Asia","c",2006,"F",1,1,12,16,10,0,"0",38,15,11,15,14,55,93
"3469","Nepal","Asia","c",2006,"NF",6,5,1,6,2,0,"0",9,6,3,4,6,19,28
"3470","Netherlands","Europe","c",2006,"F",1,1,12,16,12,0,"0",40,16,12,15,16,59,99
"3471","New Zealand","Asia","c",2006,"F",1,1,12,15,12,0,"0",39,16,11,15,15,57,96
"3472","Nicaragua","Americas","c",2006,"PF",3,3,9,11,5,0,"0",25,13,8,7,10,38,63
"3473","Niger","Africa","c",2006,"PF",3,3,10,10,7,0,"0",27,11,7,10,7,35,62
"3474","Nigeria","Africa","c",2006,"PF",4,4,6,8,6,0,"0",20,11,7,4,6,28,48
"3475","North Korea","Asia","c",2006,"NF",7,7,0,0,0,0,"0",0,0,0,0,0,0,0
"3476","Northern Cyprus","Europe","t",2006,"F",2,2,11,14,9,0,"0",34,13,9,12,12,46,80
"3477","Norway","Europe","c",2006,"F",1,1,12,16,12,0,"0",40,16,12,16,16,60,100
"3478","Oman","Middle East","c",2006,"NF",6,5,2,2,2,0,"4",10,6,4,3,5,18,28
"3479","Pakistan","Asia","c",2006,"NF",6,5,2,6,3,0,"0",11,8,6,4,6,24,35
"3480","Pakistani Kashmir","Asia","t",2006,"NF",7,5,2,3,2,2,"0",5,6,4,4,6,20,25
"3481","Palau","Asia","c",2006,"F",1,1,12,15,10,0,"0",37,16,11,15,13,55,92
"3482","Palestinian Authority Administered Territories","Middle East","t",2006,"PF",5,5,5,7,4,0,"0",16,5,5,2,5,17,33
"3483","Panama","Americas","c",2006,"F",1,2,12,15,9,0,"0",36,15,11,9,12,47,83
"3484","Papua New Guinea","Asia","c",2006,"PF",3,3,9,11,6,0,"0",26,12,9,9,8,38,64
"3485","Paraguay","Americas","c",2006,"PF",3,3,11,11,3,0,"0",25,13,8,7,10,38,63
"3486","Peru","Americas","c",2006,"F",2,3,11,14,7,0,"0",32,15,10,8,9,42,74
"3487","Philippines","Asia","c",2006,"PF",3,3,7,14,8,0,"0",29,15,9,9,10,43,72
"3488","Poland","Europe","c",2006,"F",1,1,12,16,10,0,"0",38,16,12,13,13,54,92
"3489","Portugal","Europe","c",2006,"F",1,1,12,16,12,0,"0",40,16,12,15,14,57,97
"3490","Puerto Rico","Americas","t",2006,"F",1,1,12,15,10,0,"0",37,16,11,14,14,55,92
"3491","Qatar","Middle East","c",2006,"NF",6,5,2,1,3,0,"3",9,8,2,4,4,18,27
"3492","Romania","Europe","c",2006,"F",2,2,10,13,7,0,"0",30,13,10,11,11,45,75
"3493","Russia","Eurasia","c",2006,"NF",6,5,3,5,3,0,"0",11,8,6,4,6,24,35
"3494","Rwanda","Africa","c",2006,"NF",6,5,3,3,5,0,"0",11,7,3,6,5,21,32
"3495","Samoa","Asia","c",2006,"F",2,2,9,13,10,0,"0",32,14,10,13,12,49,81
"3496","San Marino","Europe","c",2006,"F",1,1,12,16,12,0,"0",40,16,12,16,16,60,100
"3497","Sao Tome and Principe","Africa","c",2006,"F",2,2,11,14,8,0,"0",33,15,10,12,10,47,80
"3498","Saudi Arabia","Middle East","c",2006,"NF",7,6,0,0,1,0,"3",4,4,0,2,2,8,12
"3499","Senegal","Africa","c",2006,"F",2,3,12,12,9,0,"0",33,15,9,10,9,43,76
"3500","Serbia and Montenegro","Europe","c",2006,"F",3,2,9,13,7,0,"0",29,14,11,9,13,47,76
"3501","Seychelles","Africa","c",2006,"PF",3,3,8,11,7,0,"0",26,11,9,11,11,42,68
"3502","Sierra Leone","Africa","c",2006,"PF",4,3,9,10,4,0,"0",23,12,8,8,9,37,60
"3503","Singapore","Asia","c",2006,"PF",5,4,4,6,7,0,"0",17,9,4,8,12,33,50
"3504","Slovakia","Europe","c",2006,"F",1,1,12,15,10,0,"0",37,16,12,12,14,54,91
"3505","Slovenia","Europe","c",2006,"F",1,1,12,15,11,0,"0",38,16,12,14,12,54,92
"3506","Solomon Islands","Asia","c",2006,"PF",3,3,7,10,7,0,"0",24,13,9,8,12,42,66
"3507","Somalia","Africa","c",2006,"NF",6,7,0,4,4,0,"0",8,3,1,3,0,7,15
"3508","South Africa","Africa","c",2006,"F",1,2,12,14,10,0,"0",36,15,12,13,12,52,88
"3509","South Korea","Asia","c",2006,"F",1,2,11,15,10,0,"0",36,14,12,12,11,49,85
"3510","Spain","Europe","c",2006,"F",1,1,12,14,12,0,"0",38,16,12,14,15,57,95
"3511","Sri Lanka","Asia","c",2006,"PF",3,3,8,9,7,0,"0",24,9,9,7,10,35,59
"3512","St. Kitts and Nevis","Americas","c",2006,"F",1,1,12,16,10,0,"0",38,15,12,12,14,53,91
"3513","St. Lucia","Americas","c",2006,"F",1,1,12,16,10,0,"0",38,15,12,12,14,53,91
"3514","St. Vincent and the Grenadines","Americas","c",2006,"F",2,1,9,15,8,0,"0",32,15,11,13,14,53,85
"3515","Sudan","Africa","c",2006,"NF",7,7,0,4,1,4,"0",1,4,1,0,1,6,7
"3516","Suriname","Americas","c",2006,"F",2,2,12,13,8,0,"0",33,15,11,9,10,45,78
"3517","Swaziland","Africa","c",2006,"NF",7,5,0,1,0,0,"0",1,8,3,4,5,20,21
"3518","Sweden","Europe","c",2006,"F",1,1,12,16,12,0,"0",40,16,12,16,16,60,100
"3519","Switzerland","Europe","c",2006,"F",1,1,12,16,12,0,"0",40,16,12,15,16,59,99
"3520","Syria","Middle East","c",2006,"NF",7,7,0,0,1,0,"0",1,2,0,1,4,7,8
"3521","Taiwan","Asia","c",2006,"F",1,1,11,15,10,0,"0",36,16,11,15,13,55,91
"3522","Tajikistan","Eurasia","c",2006,"NF",6,5,2,4,3,0,"0",9,7,4,4,6,21,30
"3523","Tanzania","Africa","c",2006,"PF",4,3,6,10,6,0,"0",22,11,7,10,8,36,58
"3524","Thailand","Asia","c",2006,"PF",3,3,9,12,8,0,"0",29,11,8,8,11,38,67
"3525","The Gambia","Africa","c",2006,"PF",5,4,6,7,4,0,"0",17,10,6,8,8,32,49
"3526","Tibet","Asia","t",2006,"NF",7,7,0,0,1,3,"0",-2,0,0,0,5,5,3
"3527","Timor-Leste","Asia","c",2006,"PF",3,3,11,10,8,0,"0",29,13,8,8,9,38,67
"3528","Togo","Africa","c",2006,"NF",6,5,2,3,2,0,"0",7,7,3,1,7,18,25
"3529","Tonga","Asia","c",2006,"PF",5,3,3,9,3,0,"0",15,12,7,12,11,42,57
"3530","Transnistria","Eurasia","t",2006,"NF",6,6,2,3,1,0,"0",6,6,2,2,5,15,21
"3531","Trinidad and Tobago","Americas","c",2006,"F",3,2,9,11,8,0,"0",28,14,11,10,11,46,74
"3532","Tunisia","Africa","c",2006,"NF",6,5,1,3,2,0,"0",6,4,2,4,8,18,24
"3533","Turkey","Europe","c",2006,"PF",3,3,9,12,7,0,"0",28,12,7,8,10,37,65
"3534","Turkmenistan","Eurasia","c",2006,"NF",7,7,0,0,0,0,"0",0,1,0,0,0,1,1
"3535","Tuvalu","Asia","c",2006,"F",1,1,12,15,10,0,"0",37,16,12,15,14,57,94
"3536","Uganda","Africa","c",2006,"PF",5,4,3,6,5,0,"0",14,11,6,7,7,31,45
"3537","Ukraine","Eurasia","c",2006,"F",3,2,8,12,7,0,"0",27,13,10,11,11,45,72
"3538","United Arab Emirates","Middle East","c",2006,"NF",6,6,0,1,2,0,"4",7,6,1,4,4,15,22
"3539","United Kingdom","Europe","c",2006,"F",1,1,12,15,12,0,"0",39,16,12,14,15,57,96
"3540","United States","Americas","c",2006,"F",1,1,10,16,11,0,"0",37,16,11,14,15,56,93
"3541","Uruguay","Americas","c",2006,"F",1,1,12,16,11,0,"0",39,16,12,15,15,58,97
"3542","Uzbekistan","Eurasia","c",2006,"NF",7,7,0,0,0,0,"0",0,1,0,0,2,3,3
"3543","Vanuatu","Asia","c",2006,"F",2,2,9,15,8,0,"0",32,16,11,10,11,48,80
"3544","Venezuela","Americas","c",2006,"PF",4,4,10,8,5,0,"0",23,11,7,5,8,31,54
"3545","Vietnam","Asia","c",2006,"NF",7,5,0,1,1,0,"0",2,3,2,4,8,17,19
"3546","Western Sahara","Africa","t",2006,"NF",7,6,0,0,0,2,"0",-2,3,2,0,5,10,8
"3547","Yemen","Middle East","c",2006,"PF",5,5,4,6,3,0,"0",13,7,3,3,5,18,31
"3548","Zambia","Africa","c",2006,"PF",4,4,5,11,6,0,"0",22,11,8,8,7,34,56
"3549","Zimbabwe","Africa","c",2006,"NF",7,6,1,4,0,0,"0",5,5,3,1,1,10,15
